,name,awards,oscar wins and nominations,other wins,other nominations,total awards
0,Gold,1 win & 5 nominations.,0,1,5,6
1,The Choice,3 nominations,0,0,3,3
2,Middle School: The Worst Years of My Life,5 nominations.,0,0,5,5
3,Midnight Special,3 wins & 14 nominations.,0,3,14,17
4,A Monster Calls,39 wins & 56 nominations.,0,39,56,95
5,The Brothers Grimsby,,0,0,0,0
6,Pride and Prejudice and Zombies,1 win & 3 nominations,0,1,3,4
7,Mike and Dave Need Wedding Dates,4 nominations,0,0,4,4
8,Snowden,4 wins & 7 nominations,0,4,7,11
9,The Boy,6 nominations,0,0,6,6
10,Miracles from Heaven,2 wins & 5 nominations.,0,2,5,7
11,D�a del atentado,,0,0,0,0
12,The Boss,3 nominations.,0,0,3,3
13,Arrival,Won 1 Oscar. Another 64 wins & 263 nominations.,1,64,263,328
14,Gods of Egypt,2 wins & 14 nominations.,0,2,14,16
15,Warcraft: The Beginning,,0,0,0,0
16,Everybody Wants Some!!,2 wins & 17 nominations,0,2,17,19
17,The Birth of a Nation,2 wins,0,2,0,2
18,Presencia siniestra,,0,0,0,0
19,Goat,5 nominations,0,0,5,5
20,Miss Peregrine's Home for Peculiar Children,2 wins & 12 nominations.,0,2,12,14
21,War Dogs,3 nominations.,0,0,3,3
22,Sola contra el poder,,0,0,0,0
23,Deadpool,28 wins & 78 nominations.,0,28,78,106
24,The Void,3 wins & 2 nominations.,0,3,2,5
25,Moana,Nominated for 2 Oscars. 20 wins & 90 nominations total,2,20,90,112
26,The Belko Experiment,,0,0,0,0
27,Mi pap� es un gato,,0,0,0,0
28,Sleight,3 nominations.,0,0,3,3
29,Money Monster,2 nominations.,0,0,2,2
30,The Comedian,1 win,0,1,0,1
31,Captain Fantastic,Nominated for 1 Oscar. Another 15 wins & 49 nominations.,1,15,49,65
32,Hasta el �ltimo hombre,,0,0,0,0
33,Loving,Nominated for 1 Oscar. 24 wins & 89 nominations total,1,24,89,114
34,Lowriders,5 nominations.,0,0,5,5
35,Paris Can Wait,,0,0,0,0
36,Sing street; este es tu momento,,0,0,0,0
37,The Disappointments Room,1 nomination.,0,0,1,1
38,A Hologram for the King,2 wins & 3 nominations.,0,2,3,5
39,Carrie Pilby,1 win & 2 nominations.,0,1,2,3
40,Denial,Nominated for 1 BAFTA Film Award. Another 5 nominations.,0,0,6,6
41,The Darkness,,0,0,0,0
42,Manchester by the Sea,Won 2 Oscars. Another 127 wins & 263 nominations.,2,127,263,392
43,Central Intelligence,2 wins & 8 nominations.,0,2,8,10
44,Manos de piedra,,0,0,0,0
45,"Hail, Caesar!",Nominated for 1 Oscar. Another 13 wins & 43 nominations.,1,13,43,57
46,Certain Women,11 wins & 49 nominations.,0,11,49,60
47,Maudie,24 wins & 17 nominations.,0,24,17,41
48,Estaci�n Zombie: tren a Busan,,0,0,0,0
49,Max Steel,,0,0,0,0
50,Till We Meet Again,4 wins & 4 nominations.,0,4,4,8
51,Me Before You,6 wins & 6 nominations,0,6,6,12
52,Assassin's Creed,2 wins & 1 nomination.,0,2,1,3
53,The Conjuring 2,4 wins & 13 nominations,0,4,13,17
54,Meet the Blacks,,0,0,0,0
55,The Wailing,31 wins & 56 nominations.,0,31,56,87
56,The Bad Batch,1 win & 3 nominations.,0,1,3,4
57,Love & Friendship,2 wins & 1 nomination.,0,2,1,3
58,Nerve,5 nominations.,0,0,5,5
59,Fantastic Beasts and Where to Find Them,Won 1 Oscar. Another 14 wins & 54 nominations.,1,14,54,69
60,Free State of Jones,3 wins & 4 nominations,0,3,4,7
61,Free Fire,3 wins & 9 nominations,0,3,9,12
62,Pete's Dragon,3 wins & 7 nominations,0,3,7,10
63,Frantz,7 wins & 35 nominations.,0,7,35,42
64,Teenage Mutant Ninja Turtles: Out of the Shadows,10 nominations.,0,0,10,10
65,Pet,4 nominations,0,0,4,4
66,Personal Shopper,9 wins & 24 nominations.,0,9,24,33
67,Their Finest,1 win & 8 nominations.,0,1,8,9
68,Nocturnal Animals,Nominated for 1 Oscar. Another 21 wins & 150 nominations.,1,21,150,172
69,Dangal,23 wins & 6 nominations.,0,23,6,29
70,Criminal,,0,0,0,0
71,Absolutely Fabulous: The Movie,1 win & 7 nominations.,0,1,7,8
72,Norman,1 win & 1 nomination.,0,1,1,2
73,Storks,5 wins & 4 nominations,0,5,4,9
74,Office Christmas Party,1 win & 1 nomination.,0,1,1,2
75,Florence Foster Jenkins,Nominated for 2 Oscars. Another 10 wins & 45 nominations.,2,10,45,57
76,Ouija: Origin of Evil,2 wins & 7 nominations,0,2,7,9
77,Swiss Army Man,8 wins & 30 nominations,0,8,30,38
78,Our Kind of Traitor,4 nominations.,0,0,4,4
79,Paterson,10 wins & 43 nominations.,0,10,43,53
80,Sully,Nominated for 1 Oscar. 14 wins & 36 nominations total,1,14,36,51
81,Suicide Squad,Won 1 Oscar. 17 wins & 40 nominations total,1,17,40,58
82,Finding Dory,Nominated for 1 BAFTA Film Award. Another 17 wins & 45 nominations.,0,17,46,63
83,Anthropoid,1 win & 16 nominations.,0,1,16,17
84,Neruda,Nominated for 1 Golden Globe. Another 11 wins & 35 nominations.,0,11,36,47
85,Monster Trucks,2 nominations.,0,0,2,2
86,Neighbors 2: Sorority Rising,3 wins & 5 nominations,0,3,5,8
87,Ghostbusters,Nominated for 2 Oscars. Another 7 wins & 6 nominations.,2,7,6,15
88,Moonlight,Won 3 Oscars. Another 219 wins & 292 nominations.,3,219,292,514
89,Morgan,2 nominations.,0,0,2,2
90,Popstar: Never Stop Never Stopping,1 win & 6 nominations,0,1,6,7
91,Mother's Day,1 win & 6 nominations,0,1,6,7
92,Wakefield,1 win & 1 nomination,0,1,1,2
93,Mothers and Daughters,1 win & 2 nominations,0,1,2,3
94,Mr. Church,3 nominations.,0,0,3,3
95,A Street Cat Named Bob,1 win.,0,1,0,1
96,The BFG,4 wins & 26 nominations.,0,4,26,30
97,Split,9 wins & 24 nominations,0,9,24,33
98,The Angry Birds Movie,1 win & 3 nominations.,0,1,3,4
99,Genius,1 win & 6 nominations.,0,1,6,7
100,Collateral Beauty,1 win & 6 nominations.,0,1,6,7
101,Collide,1 win & 1 nomination.,0,1,1,2
102,A United Kingdom,3 wins & 5 nominations.,0,3,5,8
103,My Big Fat Greek Wedding 2,3 nominations.,0,0,3,3
104,The Accountant,3 wins & 5 nominations.,0,3,5,8
105,Complete Unknown,1 win & 4 nominations.,0,1,4,5
106,Dead Awake,4 wins & 2 nominations.,0,4,2,6
107,The 5th Wave,1 nomination.,0,0,1,1
108,From the Land of the Moon,,0,0,0,0
109,Star Trek Beyond,Nominated for 1 Oscar. Another 3 wins & 28 nominations.,1,3,28,32
110,Underworld: Blood Wars,,0,0,0,0
111,Captain America: Civil War,16 wins & 72 nominations.,0,16,72,88
112,Whiskey Tango Foxtrot,1 nomination,0,0,1,1
113,Hunt for the Wilderpeople,22 wins & 25 nominations.,0,22,25,47
114,"I, Daniel Blake",30 wins & 38 nominations total,0,30,38,68
115,20th Century Women,Nominated for 1 Oscar. Another 12 wins & 72 nominations.,1,12,72,85
116,The Light Between Oceans,1 win & 16 nominations,0,1,16,17
117,The Legend of Tarzan,2 wins & 4 nominations.,0,2,4,6
118,American Honey,Nominated for 1 BAFTA Film Award. Another 13 wins & 43 nominations.,0,13,44,57
119,Almost Christmas,3 nominations.,0,0,3,3
120,Allied,Nominated for 1 Oscar. Another 2 wins & 9 nominations.,1,2,9,12
121,Allegiant,3 wins & 12 nominations.,0,3,12,15
122,Sausage Party,1 win & 26 nominations.,0,1,26,27
123,Bleed for This,1 win & 3 nominations,0,1,3,4
124,The Jungle Book,Won 1 Oscar. Another 32 wins & 54 nominations.,1,32,54,87
125,Your name,,0,0,0,0
126,Keanu,4 wins & 5 nominations,0,4,5,9
127,31,2 wins & 8 nominations,0,2,8,10
128,Resident Evil: The Final Chapter,2 wins & 3 nominations.,0,2,3,5
129,Keeping Up with the Joneses,3 nominations,0,0,3,3
130,El beb� de Bridget Jones,,0,0,0,0
131,El cliente,,0,0,0,0
132,El demonio ne�n,,0,0,0,0
133,How to Be Single,3 nominations,0,0,3,3
134,King Cobra,1 win & 2 nominations.,0,1,2,3
135,The Edge of Seventeen,8 wins & 29 nominations.,0,8,29,37
136,Bad Santa 2,1 win & 2 nominations,0,1,2,3
137,The Infiltrator,1 nomination.,0,0,1,1
138,The Huntsman: Winter's War,16 nominations.,0,0,16,16
139,Bad Moms,3 wins & 5 nominations,0,3,5,8
140,Billy Lynn's Long Halftime Walk,2 wins & 8 nominations.,0,2,8,10
141,The Lost City of Z,6 wins & 31 nominations.,0,6,31,37
142,The Love Witch,3 wins & 5 nominations.,0,3,5,8
143,Ice Age: Collision Course,2 wins.,0,2,0,2
144,Inferno,4 wins & 1 nomination,0,4,1,5
145,Risen,3 nominations,0,0,3,3
146,Indignation,8 nominations,0,0,8,8
147,10 Cloverfield Lane,16 wins & 48 nominations.,0,16,48,64
148,Independence Day: Resurgence,3 wins & 17 nominations,0,3,17,20
149,The Other Side of the Door,2 wins & 3 nominations.,0,2,3,5
150,Incarnate,,0,0,0,0
151,Zootopia,Won 1 Oscar. Another 46 wins & 72 nominations.,1,46,72,119
152,Ben-Hur,Won 11 Oscars. Another 18 wins & 16 nominations.,11,18,16,45
153,Triple 9,4 nominations.,0,0,4,4
154,The Nice Guys,9 wins & 34 nominations,0,9,34,43
155,Rogue One,Nominated for 2 Oscars. Another 24 wins & 81 nominations.,2,24,81,107
156,The Purge: Election Year,6 nominations,0,0,6,6
157,In a Valley of Violence,,0,0,0,0
158,Zoolander 2,7 wins & 17 nominations.,0,7,17,24
159,13 Hours,Nominated for 1 Oscar. 5 nominations total,0,1,5,6
160,Eddie the Eagle,2 wins & 9 nominations,0,2,9,11
161,Trolls,Nominated for 1 Oscar. Another 4 wins & 35 nominations.,1,4,35,40
162,Rules Don't Apply,3 wins & 10 nominations,0,3,10,13
163,Jack Reacher: Sin regreso,,0,0,0,0
164,The Magnificent Seven,5 wins & 12 nominations.,0,5,12,17
165,Jackie,Nominated for 3 Oscars. 44 wins & 166 nominations total,3,44,166,213
166,Batman: The Killing Joke,1 win & 2 nominations.,0,1,2,3
167,Batman v Superman: Dawn of Justice,14 wins & 33 nominations.,0,14,33,47
168,Jason Bourne,3 wins & 20 nominations.,0,3,20,23
169,Boo! A Madea Halloween,6 nominations.,0,0,6,6
170,Kingsglaive: Final Fantasy XV,2 nominations,0,0,2,2
171,Leap!,,0,0,0,0
172,Dirty Grandpa,2 wins & 11 nominations,0,2,11,13
173,The Founder,1 win & 5 nominations.,0,1,5,6
174,The Forest,1 win & 1 nomination,0,1,1,2
175,El especialista: La resurrecci�n,,0,0,0,0
176,Shin Godzilla,13 wins & 10 nominations.,0,13,10,23
177,Hidden Figures,Nominated for 3 Oscars. Another 36 wins & 91 nominations.,3,36,91,130
178,Buster's Mal Heart,3 nominations.,0,0,3,3
179,The Finest Hours,2 wins.,0,2,0,2
180,Ella es un monstruo,,0,0,0,0
181,Caf� Society,,0,0,0,0
182,Lights Out,3 wins & 9 nominations,0,3,9,12
183,Silence,Nominated for 1 Oscar. Another 6 wins & 56 nominations.,1,6,56,63
184,Lion,Nominated for 6 Oscars. Another 58 wins & 103 nominations.,6,58,103,167
185,Hell or High Water,Nominated for 4 Oscars. 46 wins & 171 nominations total,4,46,171,221
186,The Eyes of My Mother,5 wins & 14 nominations.,0,5,14,19
187,A Cure for Wellness,4 wins & 5 nominations.,0,4,5,9
188,The Take,,0,0,0,0
189,Live by Night,3 nominations.,0,0,3,3
190,Why Him?,1 win,0,1,0,1
191,The Exception,2 nominations.,0,0,2,2
192,London Has Fallen,1 win & 2 nominations.,0,1,2,3
193,Alice Through the Looking Glass,4 wins & 20 nominations,0,4,20,24
194,Los ilusionistas 2,,0,0,0,0
195,White Girl,1 win & 3 nominations.,0,1,3,4
196,Toni Erdmann,Nominated for 1 Oscar. Another 58 wins & 83 nominations.,1,58,83,142
197,Fences,Won 1 Oscar. Another 56 wins & 120 nominations.,1,56,120,177
198,La La Land,Won 6 Oscars. Another 236 wins & 287 nominations.,6,236,287,529
199,El fin del sue�o americano,,0,0,0,0
200,La bruja de Blair,,0,0,0,0
201,The Handmaiden,Won 1 BAFTA Film Award. Another 66 wins & 106 nominations.,0,67,106,173
202,The Great Wall,3 wins & 2 nominations.,0,3,2,5
203,Doctor Strange,Nominated for 1 Oscar. Another 19 wins & 67 nominations.,1,19,67,87
204,La tortuga roja,,0,0,0,0
205,Don't Breathe,7 wins & 21 nominations,0,7,21,28
206,Kung Fu Panda 3,1 win & 10 nominations.,0,1,10,11
207,X-Men: Apocalypse,1 win & 19 nominations.,0,1,19,20
208,La vida secreta de tus mascotas,,0,0,0,0
209,Horizonte profundo,,0,0,0,0
210,Lady Macbeth,Nominated for 2 BAFTA Film Awards. Another 21 wins & 51 nominations.,0,21,53,74
211,The Girl on the Train,Nominated for 1 BAFTA Film Award. Another 4 wins & 12 nominations.,0,4,13,17
212,The Hollars,1 win & 5 nominations,0,1,5,6
213,Kubo and the Two Strings,Nominated for 2 Oscars. Another 33 wins & 65 nominations.,2,33,65,100
214,The Shallows,1 win & 15 nominations,0,1,15,16
215,Sinister 2,1 win & 3 nominations.,0,1,3,4
216,Straight Outta Compton,Nominated for 1 Oscar. 28 wins & 40 nominations total,1,28,40,69
217,Desierto,2 wins & 21 nominations.,0,2,21,23
218,Scouts Guide to the Zombie Apocalypse,5 nominations.,0,0,5,5
219,Sisters,4 nominations.,0,0,4,4
220,Secret in Their Eyes,2 wins & 3 nominations,0,2,3,5
221,Shaun the Sheep Movie,Nominated for 1 Oscar. 5 wins & 50 nominations total,1,5,50,56
222,Demolition,1 win & 2 nominations.,0,1,2,3
223,Self/less,,0,0,0,0
224,Star Wars: The Force Awakens,,0,0,0,0
225,Spy,Nominated for 2 Golden Globes. Another 6 wins & 28 nominations.,0,6,30,36
226,San Andreas,2 wins & 10 nominations.,0,2,10,12
227,Dragon Blade,4 wins & 2 nominations.,0,4,2,6
228,American Ultra,,0,0,0,0
229,Sleeping with Other People,2 nominations.,0,0,2,2
230,Drishyam,1 win & 2 nominations.,0,1,2,3
231,Sicario,Nominated for 3 Oscars. 15 wins & 158 nominations total,3,15,158,176
232,Steve Jobs,Nominated for 2 Oscars. Another 28 wins & 112 nominations.,2,28,112,142
233,Tomorrowland,2 wins & 19 nominations.,0,2,19,21
234,Slow West,7 wins & 20 nominations.,0,7,20,27
235,Run All Night,,0,0,0,0
236,Danny Collins,1 win & 4 nominations.,0,1,4,5
237,Spectre,Won 1 Oscar. Another 7 wins & 37 nominations.,1,7,37,45
238,Spotlight,Won 2 Oscars. 124 wins & 143 nominations total,2,124,143,269
239,Dope,5 wins & 24 nominations,0,5,24,29
240,Strange Magic,1 win & 4 nominations.,0,1,4,5
241,Daddy's Home,1 win & 4 nominations.,0,1,4,5
242,The Good Dinosaur,9 wins & 41 nominations.,0,9,41,50
243,The Hunger Games: Mockingjay - Part 2,16 wins & 34 nominations,0,16,34,50
244,Born to Be Blue,3 wins & 7 nominations.,0,3,7,10
245,The Hateful Eight,Won 1 Oscar. 43 wins & 116 nominations total,1,43,116,160
246,The Hallow,12 wins & 7 nominations,0,12,7,19
247,The Gunman,1 nomination.,0,0,1,1
248,Bridge of Spies,Won 1 Oscar. Another 29 wins & 103 nominations.,1,29,103,133
249,Brooklyn,Nominated for 3 Oscars. Another 38 wins & 158 nominations.,3,38,158,199
250,The Girl in the Book,1 nomination.,0,0,1,1
251,The Second Best Exotic Marigold Hotel,4 nominations.,0,0,4,4
252,Burnt,6 wins & 1 nomination,0,6,1,7
253,The SpongeBob Movie: Sponge Out of Water,1 win & 9 nominations.,0,1,9,10
254,Baahubali: The Beginning,,0,0,0,0
255,The Stanford Prison Experiment,4 wins & 3 nominations.,0,4,3,7
256,The Family Fang,1 win & 1 nomination.,0,1,1,2
257,Avengers: Age of Ultron,8 wins & 49 nominations,0,8,49,57
258,The Intern,1 win & 8 nominations,0,1,8,9
259,The Sea of Trees,2 nominations,0,0,2,2
260,Captive,3 nominations,0,0,3,3
261,The Lure,22 wins & 18 nominations.,0,22,18,40
262,The Overnight,1 win & 3 nominations.,0,1,3,4
263,The Night Before,2 nominations.,0,0,2,2
264,Beasts of No Nation,32 wins & 57 nominations total,0,32,57,89
265,The Meddler,6 nominations,0,0,6,6
266,The Martian,Nominated for 7 Oscars. Another 38 wins & 193 nominations.,7,38,193,238
267,The Man from U.N.C.L.E.,7 wins & 5 nominations,0,7,5,12
268,The Man Who Knew Infinity,1 win & 3 nominations,0,1,3,4
269,The Longest Ride,1 win & 5 nominations,0,1,5,6
270,Bajo la arena,,0,0,0,0
271,The Lazarus Effect,2 nominations,0,0,2,2
272,The Last Witch Hunter,1 nomination.,0,0,1,1
273,Black Mass,6 wins & 24 nominations.,0,6,24,30
274,Blackhat,1 win & 5 nominations,0,1,5,6
275,Blackway,,0,0,0,0
276,The Lady in the Van,1 win & 8 nominations total,0,1,8,9
277,The Invitation,4 wins & 15 nominations.,0,4,15,19
278,The End of the Tour,4 wins & 18 nominations,0,4,18,22
279,Attack on Titan: Part 1,2 nominations.,0,0,2,2
280,Strangerland,1 win & 6 nominations.,0,1,6,7
281,Tangerine,25 wins & 43 nominations,0,25,43,68
282,The Wedding Ringer,2 wins & 4 nominations.,0,2,4,6
283,Conspiraci�n y poder,,0,0,0,0
284,The Witch,,0,0,0,0
285,Terminator Genisys,10 nominations.,0,0,10,10
286,Cop Car,1 win & 4 nominations,0,1,4,5
287,Ant-Man,Nominated for 1 BAFTA Film Award. Another 4 wins & 33 nominations.,0,4,34,38
288,Ted 2,3 wins & 4 nominations.,0,3,4,7
289,Tale of Tales,21 wins & 15 nominations.,0,21,15,36
290,The Age of Adaline,1 win & 10 nominations,0,1,10,11
291,Creed,Nominated for 1 Oscar. 44 wins & 65 nominations total,1,44,65,110
292,Crimenes ocultos,,0,0,0,0
293,Anomalisa,Nominated for 1 Oscar. 25 wins & 79 nominations total,1,25,79,105
294,Crimson Peak,6 wins & 42 nominations.,0,6,42,48
295,Synchronicity,1 win & 1 nomination.,0,1,1,2
296,Summertime,Nominated for 2 Oscars. 2 wins & 5 nominations total,2,2,5,9
297,Suffragette,17 wins & 20 nominations.,0,17,20,37
298,The Assassin,,0,0,0,0
299,The Dressmaker,15 wins & 41 nominations.,0,15,41,56
300,Chi-Raq,4 wins & 14 nominations,0,4,14,18
301,Carol,Nominated for 6 Oscars. Another 77 wins & 248 nominations.,6,77,248,331
302,The Diary of a Teenage Girl,16 wins & 37 nominations,0,16,37,53
303,The Daughter,10 wins & 26 nominations,0,10,26,36
304,The Danish Girl,Won 1 Oscar. Another 30 wins & 79 nominations.,1,30,79,110
305,The DUFF,1 win & 8 nominations.,0,1,8,9
306,The D Train,2 nominations.,0,0,2,2
307,Chappie,3 nominations.,0,0,3,3
308,The Bronze,1 nomination.,0,0,1,1
309,Closet Monster,10 wins & 11 nominations.,0,10,11,21
310,Cinderella,Nominated for 1 Oscar. 8 wins & 37 nominations total,1,8,37,46
311,The Boy Next Door,1 win & 6 nominations.,0,1,6,7
312,The Blackcoat's Daughter,6 nominations.,0,0,6,6
313,The Vatican Tapes,,0,0,0,0
314,The Big Short,Won 1 Oscar. Another 36 wins & 81 nominations.,1,36,81,118
315,The Visit,1 win & 14 nominations.,0,1,14,15
316,The Walk,3 wins & 17 nominations,0,3,17,20
317,Rock the Kasbah,,0,0,0,0
318,El gran peque�o,,0,0,0,0
319,We Are Your Friends,,0,0,0,0
320,Minions,Nominated for 1 BAFTA Film Award. Another 4 wins & 26 nominations.,0,4,27,31
321,Alvin and the Chipmunks: The Road Chip,1 win & 4 nominations,0,1,4,5
322,Goosebumps,4 nominations,0,0,4,4
323,Green Room,8 wins & 25 nominations,0,8,25,33
324,Me and Earl and the Dying Girl,18 wins & 30 nominations,0,18,30,48
325,"McFarland, USA",4 wins & 3 nominations,0,4,3,7
326,Maze Runner: The Scorch Trials,2 wins & 5 nominations.,0,2,5,7
327,Manifesto,5 wins & 5 nominations.,0,5,5,10
328,Our Brand Is Crisis,2 nominations,0,0,2,2
329,Magic Mike XXL,2 wins & 5 nominations.,0,2,5,7
330,Maggie's Plan,1 win & 9 nominations.,0,1,9,10
331,Maggie,1 win & 4 nominations.,0,1,4,5
332,Mad Max: Fury Road,Won 6 Oscars. Another 239 wins & 231 nominations.,6,239,231,476
333,Hardcore: Misi�n extrema,,0,0,0,0
334,Macbeth,4 wins & 30 nominations.,0,4,30,34
335,Love the Coopers,2 nominations,0,0,2,2
336,Misi�n: imposible 5 - Naci�n secreta,,0,0,0,0
337,War Room,5 wins,0,5,0,5
338,Miss You Already,1 nomination.,0,0,1,1
339,Mississippi Grind,2 wins & 3 nominations.,0,2,3,5
340,Vacation,1 win & 3 nominations.,0,1,3,4
341,Freeheld,1 win & 10 nominations.,0,1,10,11
342,Frente al mar,,0,0,0,0
343,A Walk in the Woods,1 nomination,0,0,1,1
344,M�s fuerte que las bombas,,0,0,0,0
345,Furious 7,35 wins & 36 nominations.,0,35,36,71
346,Victor Frankenstein,4 wins & 1 nomination.,0,4,1,5
347,Mustang: belleza salvaje,,0,0,0,0
348,Mr. Right,2 nominations.,0,0,2,2
349,Get Hard,2 nominations.,0,0,2,2
350,Mr. Holmes,19 nominations.,0,0,19,19
351,Mortdecai,1 win & 9 nominations.,0,1,9,10
352,Girl Asleep,7 wins & 23 nominations.,0,7,23,30
353,Mistress America,2 wins & 14 nominations,0,2,14,16
354,Los 33,,0,0,0,0
355,"Hello, My Name Is Doris",2 wins & 11 nominations.,0,2,11,13
356,A Bigger Splash,4 wins & 19 nominations,0,4,19,23
357,3 Generations,1 nomination,0,0,1,1
358,Jurassic World,15 wins & 58 nominations.,0,15,58,73
359,Jupiter Ascending,4 wins & 16 nominations.,0,4,16,20
360,Joy,Nominated for 1 Oscar. Another 8 wins & 22 nominations.,1,8,22,31
361,I Saw the Light,,0,0,0,0
362,Z for Zachariah,3 nominations.,0,0,3,3
363,I'll See You in My Dreams,8 nominations,0,0,8,8
364,Jenny's Wedding,1 nomination,0,0,1,1
365,Jem and the Holograms,2 nominations,0,0,2,2
366,Jane Got a Gun,1 nomination,0,0,1,1
367,Irrational Man,3 nominations,0,0,3,3
368,Ip Man 3,5 wins & 21 nominations.,0,5,21,26
369,In the Heart of the Sea,1 win & 5 nominations,0,1,5,6
370,Into the Forest,2 wins & 3 nominations.,0,2,3,5
371,Insurgent,4 wins & 17 nominations.,0,4,17,21
372,Inside Out,Won 1 Oscar. Another 99 wins & 116 nominations.,1,99,116,216
373,Youth,Nominated for 1 Oscar. Another 24 wins & 57 nominations.,1,24,57,82
374,Knight of Cups,4 wins & 9 nominations,0,4,9,13
375,Legend,6 wins & 12 nominations.,0,6,12,18
376,Knock Knock,,0,0,0,0
377,90 Minutes in Heaven,,0,0,0,0
378,Woman in Gold,6 nominations.,0,0,6,6
379,High-Rise,6 wins & 14 nominations.,0,6,14,20
380,Hitman: Agent 47,2 nominations.,0,0,2,2
381,La �ltima ola,,0,0,0,0
382,Home,3 wins & 9 nominations.,0,3,9,12
383,La noche del demonio: Capitulo 3,,0,0,0,0
384,La langosta,,0,0,0,0
385,La habitaci�n,,0,0,0,0
386,45 Years,Nominated for 1 Oscar. Another 22 wins & 61 nominations.,1,22,61,84
387,Krisha,16 wins & 28 nominations,0,16,28,44
388,Krampus,4 wins & 14 nominations,0,4,14,18
389,Hot Tub Time Machine 2,2 nominations.,0,0,2,2
390,Hotel Transylvania 2,1 win & 10 nominations.,0,1,10,11
391,Focus,3 nominations.,0,0,3,3
392,The Peanuts Movie,Nominated for 1 Golden Globe. Another 2 wins & 47 nominations.,0,2,48,50
393,Regression,1 win & 2 nominations.,0,1,2,3
394,Pixels,5 wins & 9 nominations.,0,5,9,14
395,Trumbo,Nominated for 1 Oscar. Another 8 wins & 44 nominations.,1,8,44,53
396,Turbo Kid,22 wins & 14 nominations.,0,22,14,36
397,True Story,4 nominations.,0,0,4,4
398,Ricki and the Flash,4 nominations,0,0,4,4
399,Experimenter,3 wins & 5 nominations.,0,3,5,8
400,Far from the Madding Crowd,2 wins & 12 nominations,0,2,12,14
401,Unfinished Business,1 nomination,0,0,1,1
402,Poltergeist,Nominated for 3 Oscars. Another 4 wins & 4 nominations.,3,4,4,11
403,Esta chica es un desastre,,0,0,0,0
404,The Perfect Guy,2 wins & 3 nominations.,0,2,3,5
405,Equals,1 win & 5 nominations,0,1,5,6
406,Revenant: El Renacido,,0,0,0,0
407,Aloha,2 wins & 7 nominations.,0,2,7,9
408,El hijo de Sa�l,,0,0,0,0
409,El nuevo nuevo testamento,,0,0,0,0
410,Eye in the Sky,3 wins & 10 nominations.,0,3,10,13
411,Project Almanac,,0,0,0,0
412,Revancha,,0,0,0,0
413,Una historia de amor y oscuridad,,0,0,0,0
414,Paul Blart: Mall Cop 2,1 win & 9 nominations.,0,1,9,10
415,Pan,8 nominations,0,0,8,8
416,El transportador recargado,,0,0,0,0
417,Paper Towns,4 wins & 3 nominations.,0,4,3,7
418,Una sonrisa a la vida,,0,0,0,0
419,Embrace of the Serpent,,0,0,0,0
420,Fifty Shades of Grey,Nominated for 1 Oscar. Another 9 wins & 27 nominations.,1,9,27,37
421,Everest,1 win & 8 nominations.,0,1,8,9
422,El principito,,0,0,0,0
423,Pitch Perfect 2,9 wins & 16 nominations.,0,9,16,25
424,Remember,6 wins & 24 nominations,0,6,24,30
425,Paranormal Activity: The Ghost Dimension,1 win & 4 nominations,0,1,4,5
426,Un hombre gru��n,,0,0,0,0
427,Kid Cannabis,1 nomination,0,0,1,1
428,Kill Me Three Times,4 nominations.,0,0,4,4
429,The Imitation Game,Won 1 Oscar. Another 48 wins & 162 nominations.,1,48,162,211
430,The Interview,1 win & 6 nominations.,0,1,6,7
431,Kill the Messenger,3 wins & 6 nominations.,0,3,6,9
432,Kingsman: The Secret Service,10 wins & 32 nominations.,0,10,32,42
433,Serena,1 win.,0,1,0,1
434,Selma,Won 1 Oscar. Another 57 wins & 91 nominations.,1,57,91,149
435,The Hunger Games: Mockingjay - Part 1,21 wins & 32 nominations.,0,21,32,53
436,The Gambler,1 win & 3 nominations,0,1,3,4
437,Las nubes de Mar�a,,0,0,0,0
438,Laggies,1 win & 1 nomination,0,1,1,2
439,Relatos salvajes,,0,0,0,0
440,La salvaci�n,,0,0,0,0
441,The Grand Budapest Hotel,Won 4 Oscars. Another 130 wins & 226 nominations.,4,130,226,360
442,Divergent,7 wins & 11 nominations.,0,7,11,18
443,The Guest,4 wins & 13 nominations.,0,4,13,17
444,Sex Tape,2 wins & 3 nominations.,0,2,3,5
445,Seventh Son,2 wins & 1 nomination,0,2,1,3
446,Honeymoon,5 nominations.,0,0,5,5
447,El penthouse,,0,0,0,0
448,The Hobbit: The Battle of the Five Armies,Nominated for 1 Oscar. Another 8 wins & 54 nominations.,1,8,54,63
449,Boyhood,Won 1 Oscar. Another 172 wins & 218 nominations.,1,172,218,391
450,Horrible Bosses 2,1 win & 3 nominations.,0,1,3,4
451,El payaso del mal,,0,0,0,0
452,The Homesman,5 wins & 14 nominations.,0,5,14,19
453,El dador de recuerdos,,0,0,0,0
454,The Hundred-Foot Journey,2 wins & 4 nominations.,0,2,4,6
455,How to Train Your Dragon 2,Nominated for 1 Oscar. 15 wins & 61 nominations total,1,15,61,77
456,Paddington,Nominated for 1 BAFTA Film Award. Another 3 wins & 6 nominations.,0,3,7,10
457,The Judge,Nominated for 1 Oscar. Another 3 wins & 8 nominations.,1,3,8,12
458,Jack Ryan: Shadow Recruit,3 nominations.,0,0,3,3
459,It Follows,25 wins & 43 nominations.,0,25,43,68
460,Beyond the Lights,Nominated for 1 Oscar. Another 4 wins & 25 nominations.,1,4,25,30
461,Rudderless,1 win & 1 nomination.,0,1,1,2
462,The Maze Runner,4 wins & 12 nominations.,0,4,12,16
463,In Order of Disappearance,,0,0,0,0
464,Better Living Through Chemistry,,0,0,0,0
465,Into the Woods,Nominated for 3 Oscars. Another 10 wins & 71 nominations.,3,10,71,84
466,Ride Along,1 win & 7 nominations.,0,1,7,8
467,The Monuments Men,3 wins & 3 nominations.,0,3,3,6
468,Into the Storm,2 wins & 1 nomination.,0,2,1,3
469,Rio 2,2 wins & 24 nominations.,0,2,24,26
470,The November Man,,0,0,0,0
471,Interstellar,Won 1 Oscar. Another 43 wins & 148 nominations.,1,43,148,192
472,The One I Love,2 wins & 2 nominations.,0,2,2,4
473,Dumb and Dumber To,1 win & 7 nominations,0,1,7,8
474,The Other Woman,3 wins & 5 nominations,0,3,5,8
475,Before We Go,,0,0,0,0
476,Before I Go to Sleep,,0,0,0,0
477,Big Eyes,Won 1 Golden Globe. Another 2 wins & 18 nominations.,0,3,18,21
478,Big Game,1 win & 8 nominations.,0,1,8,9
479,Just Before I Go,,0,0,0,0
480,Edge of Tomorrow,11 wins & 38 nominations.,0,11,38,49
481,The Keeping Room,3 wins & 8 nominations,0,3,8,11
482,Blended,1 win & 10 nominations,0,1,10,11
483,H�ctor y el secreto de la felicidad,,0,0,0,0
484,Saving Christmas,,0,0,0,0
485,The Last Five Years,1 win & 1 nomination.,0,1,1,2
486,Dracula Untold,3 wins & 5 nominations,0,3,5,8
487,Draft Day,1 nomination.,0,0,1,1
488,El recuerdo de Marnie,,0,0,0,0
489,I Origins,2 wins & 3 nominations,0,2,3,5
490,The Legend of Hercules,1 win & 7 nominations.,0,1,7,8
491,The Lego Movie,Nominated for 1 Oscar. Another 72 wins & 66 nominations.,1,72,66,139
492,John Wick,5 wins & 10 nominations.,0,5,10,15
493,Birdman or (The Unexpected Virtue of Ignorance),Won 4 Oscars. Another 189 wins & 291 nominations.,4,189,291,484
494,The Little Death,2 wins & 10 nominations,0,2,10,12
495,"I, Frankenstein",1 nomination,0,0,1,1
496,Jersey Boys,4 wins & 2 nominations,0,4,2,6
497,Sabotage,2 wins & 5 nominations,0,2,5,7
498,If I Stay,3 wins & 1 nomination.,0,3,1,4
499,Big Hero 6,Won 1 Oscar. Another 16 wins & 58 nominations.,1,16,58,75
500,Black Sea,,0,0,0,0
501,Cake,5 wins & 8 nominations,0,5,8,13
502,Left Behind,5 nominations.,0,0,5,5
503,The Bag Man,,0,0,0,0
504,The Amazing Spider-Man 2,4 wins & 30 nominations.,0,4,30,34
505,Step Up All In,,0,0,0,0
506,Muppets Most Wanted,3 wins & 11 nominations.,0,3,11,14
507,Cold in July,1 win & 8 nominations,0,1,8,9
508,Mr. Peabody & Sherman,2 wins & 16 nominations.,0,2,16,18
509,Dawn of the Planet of the Apes,Nominated for 1 Oscar. 17 wins & 48 nominations total,1,17,48,66
510,The Babadook,56 wins & 64 nominations.,0,56,64,120
511,Moms' Night Out,1 win.,0,1,0,1
512,Mommy,54 wins & 66 nominations.,0,54,66,120
513,Still Alice,Won 1 Oscar. 34 wins & 35 nominations total,1,34,35,70
514,St. Vincent,6 wins & 23 nominations.,0,6,23,29
515,The Best of Me,,0,0,0,0
516,Spring,5 wins & 13 nominations.,0,5,13,18
517,God's Not Dead,1 win.,0,1,0,1
518,God's Pocket,1 nomination,0,0,1,1
519,Pompeya,2 wins & 1 nomination.,0,2,1,3
520,The Book of Life,Nominated for 1 Golden Globe. Another 3 wins & 28 nominations.,0,3,29,32
521,Fury,5 wins & 24 nominations.,0,5,24,29
522,Penguins of Madagascar,8 nominations,0,0,8,8
523,Sin City: A Dame to Kill For,4 wins & 6 nominations.,0,4,6,10
524,Frank,13 wins & 18 nominations.,0,13,18,31
525,Ouija,1 win.,0,1,0,1
526,Non-Stop,1 nomination.,0,0,1,1
527,Fortaleza prohibida,,0,0,0,0
528,Noah,1 win & 19 nominations.,0,1,19,20
529,Tal vez es para siempre,,0,0,0,0
530,Foxcatcher,Nominated for 5 Oscars. 13 wins & 81 nominations total,5,13,81,99
531,Tammy,1 win & 7 nominations,0,1,7,8
532,No Good Deed,2 wins & 2 nominations,0,2,2,4
533,Fuerza mayor,,0,0,0,0
534,Nightcrawler,Nominated for 1 Oscar. Another 42 wins & 123 nominations.,1,42,123,166
535,Night at the Museum: Secret of the Tomb,1 win & 4 nominations.,0,1,4,5
536,Cooties,1 win & 4 nominations.,0,1,4,5
537,Pawn Sacrifice,1 win & 1 nomination,0,1,1,2
538,Neighbors,7 wins & 11 nominations.,0,7,11,18
539,Testament of Youth,5 wins & 6 nominations.,0,5,6,11
540,Need for Speed,1 win & 5 nominations.,0,1,5,6
541,That Awkward Moment,1 win & 2 nominations.,0,1,2,3
542,The Boxtrolls,Nominated for 1 Oscar. Another 8 wins & 60 nominations.,1,8,60,69
543,Exodus: Gods and Kings,5 nominations.,0,0,5,5
544,Gone Girl,Nominated for 1 Oscar. Another 64 wins & 187 nominations.,1,64,187,252
545,The Expendables 3,2 wins & 5 nominations,0,2,5,7
546,Captain America: The Winter Soldier,Nominated for 1 Oscar. Another 5 wins & 51 nominations.,1,5,51,57
547,Love & Mercy,2 wins & 1 nomination.,0,2,1,3
548,Lost River,3 wins & 5 nominations.,0,3,5,8
549,Endless Love,1 win.,0,1,0,1
550,The Equalizer,1 win & 9 nominations.,0,1,9,10
551,Locos por las nueces,,0,0,0,0
552,Camp X-Ray,6 nominations,0,0,6,6
553,Heaven Is for Real,1 win & 5 nominations.,0,1,5,6
554,Calvary,9 wins & 32 nominations.,0,9,32,41
555,Million Dollar Arm,1 win & 2 nominations.,0,1,2,3
556,Heaven Knows What,5 wins & 12 nominations.,0,5,12,17
557,PK,20 wins & 15 nominations,0,20,15,35
558,Life After Beth,6 nominations,0,0,6,6
559,The Fault in Our Stars,21 wins & 17 nominations.,0,21,17,38
560,Let's Be Cops,2 nominations.,0,0,2,2
561,B�squeda implacable 3,,0,0,0,0
562,Enredos en Broadway,,0,0,0,0
563,Lucy,1 win & 12 nominations.,0,1,12,13
564,The Duke of Burgundy,7 wins & 28 nominations,0,7,28,35
565,Entrevista con unos vampiros,,0,0,0,0
566,Good Kill,1 nomination.,0,0,1,1
567,Ex Machina,Won 1 Oscar. Another 72 wins & 161 nominations.,1,72,161,234
568,Goodnight Mommy,22 wins & 36 nominations.,0,22,36,58
569,Dear White People,13 wins & 28 nominations.,0,13,28,41
570,Chef,2 wins & 4 nominations.,0,2,4,6
571,"Men, Women & Children",,0,0,0,0
572,Song of the Sea,Nominated for 1 Oscar. Another 11 wins & 25 nominations.,1,11,25,37
573,Predestination,12 wins & 19 nominations,0,12,19,31
574,Guardians of the Galaxy,Nominated for 2 Oscars. Another 52 wins & 100 nominations.,2,52,100,154
575,Mapa a las estrellas,,0,0,0,0
576,Deliver Us from Evil,2 wins & 4 nominations.,0,2,4,6
577,Maleficent,Nominated for 1 Oscar. Another 12 wins & 42 nominations.,1,12,42,55
578,Magic in the Moonlight,1 win & 1 nomination.,0,1,1,2
579,Promesa de Vida,,0,0,0,0
580,The Disappearance of Eleanor Rigby: Them,3 wins & 9 nominations.,0,3,9,12
581,Escobar,1 nomination.,0,0,1,1
582,The Drop,4 wins & 5 nominations.,0,4,5,9
583,Earth to Echo,2 wins & 1 nomination.,0,2,1,3
584,'71,Nominated for 1 BAFTA Film Award. Another 13 wins & 30 nominations.,0,13,31,44
585,Inherent Vice,Nominated for 2 Oscars. 15 wins & 98 nominations total,2,15,98,115
586,A Million Ways to Die in the West,6 nominations.,0,0,6,6
587,The Rover,3 wins & 19 nominations,0,3,19,22
588,Barefoot,1 nomination,0,0,1,1
589,Addicted,,0,0,0,0
590,About Last Night,1 nomination,0,0,1,1
591,Vampire Academy,2 nominations.,0,0,2,2
592,A Walk Among the Tombstones,1 nomination.,0,0,1,1
593,Walk of Shame,,0,0,0,0
594,A Most Wanted Man,3 wins & 6 nominations,0,3,6,9
595,A Most Violent Year,15 wins & 52 nominations.,0,15,52,67
596,A Long Way Down,,0,0,0,0
597,Wish I Was Here,6 nominations.,0,0,6,6
598,The Raid 2,5 wins & 10 nominations.,0,5,10,15
599,The Quiet Ones,7 nominations.,0,0,7,7
600,A Little Chaos,2 nominations,0,0,2,2
601,When the Game Stands Tall,1 nomination,0,0,1,1
602,A Haunted House 2,,0,0,0,0
603,While We're Young,1 win & 3 nominations.,0,1,3,4
604,Whiplash,Won 3 Oscars. Another 94 wins & 145 nominations.,3,94,145,242
605,Wild,Nominated for 2 Oscars. Another 13 wins & 67 nominations.,2,13,67,82
606,A Brilliant Young Mind,4 wins & 11 nominations.,0,4,11,15
607,Unbroken,Nominated for 3 Oscars. 15 wins & 33 nominations total,3,15,33,51
608,Una buena mentira,,0,0,0,0
609,Una Se�al En La Tormenta,,0,0,0,0
610,"Alexander and the Terrible, Horrible, No Good, Very Bad Day",1 win & 8 nominations.,0,1,8,9
611,The Theory of Everything,Won 1 Oscar. Another 24 wins & 124 nominations.,1,24,124,149
612,The Tribe,29 wins & 25 nominations.,0,29,25,54
613,The Two Faces of January,3 nominations,0,0,3,3
614,"As Above, So Below",1 win & 6 nominations.,0,1,6,7
615,The Signal,1 win & 3 nominations,0,1,3,4
616,The Woman in Black 2: Angel of Death,2 wins & 2 nominations.,0,2,2,4
617,Annie,Nominated for 2 Oscars. Another 2 wins & 11 nominations.,2,2,11,15
618,Annabelle,3 wins & 7 nominations.,0,3,7,10
619,Think Like a Man Too,2 wins & 4 nominations,0,2,4,6
620,And So It Goes,1 nomination.,0,0,1,1
621,This Is Where I Leave You,1 nomination.,0,0,1,1
622,Top Five,5 wins & 21 nominations.,0,5,21,26
623,American Sniper,Won 1 Oscar. 24 wins & 43 nominations total,1,24,43,68
624,Transcendence,3 wins & 5 nominations,0,3,5,8
625,Transformers: Age of Extinction,5 wins & 23 nominations.,0,5,23,28
626,Trash,2 wins & 10 nominations total,0,2,10,12
627,Tusk,2 wins & 7 nominations,0,2,7,9
628,"Two Days, One Night",,0,0,0,0
629,Two Night Stand,1 nomination,0,0,1,1
630,Winter's Tale,2 nominations,0,0,2,2
631,Unfriended,3 wins & 6 nominations.,0,3,6,9
632,99 Homes,Nominated for 1 Golden Globe. Another 12 wins & 23 nominations.,0,12,24,36
633,X-Men: Days of Future Past,Nominated for 1 Oscar. 16 wins & 48 nominations total,1,16,48,65
634,13 Sins,3 nominations,0,0,3,3
635,Zombeavers,,0,0,0,0
636,300: Rise of an Empire,2 wins & 7 nominations.,0,2,7,9
637,3 Days to Kill,,0,0,0,0
638,12 horas para sobrevivir,,0,0,0,0
639,22 Jump Street,7 wins & 25 nominations,0,7,25,32
640,5 to 7,1 win & 1 nomination.,0,1,1,2
641,Runner Runner,2 nominations.,0,0,2,2
642,All Is Lost,Nominated for 1 Oscar. 3 wins & 48 nominations total,1,3,48,52
643,El expreso del miedo,,0,0,0,0
644,Despicable Me 2,Nominated for 2 Oscars. Another 12 wins & 64 nominations.,2,12,64,78
645,Delivery Man,,0,0,0,0
646,Snitch,1 nomination,0,0,1,1
647,Thor: The Dark World,4 wins & 21 nominations.,0,4,21,25
648,This Is the End,10 wins & 22 nominations.,0,10,22,32
649,Anchorman 2: The Legend Continues,1 win & 23 nominations.,0,1,23,24
650,El gran Gatsby,,0,0,0,0
651,Dead Man Down,,0,0,0,0
652,Jack the Giant Slayer,1 win & 4 nominations,0,1,4,5
653,Star Trek Into Darkness,Nominated for 1 Oscar. Another 7 wins & 58 nominations.,1,7,58,66
654,Zonas h�medas,,0,0,0,0
655,Starred Up,17 wins & 22 nominations.,0,17,22,39
656,I'm So Excited!,1 nomination.,0,0,1,1
657,Dark Skies,,0,0,0,0
658,Stoker,4 wins & 45 nominations.,0,4,45,49
659,The Zero Theorem,2 wins & 7 nominations.,0,2,7,9
660,Side Effects,5 nominations.,0,0,5,5
661,Amores infieles,,0,0,0,0
662,Diana,2 wins & 2 nominations,0,2,2,4
663,2 Guns,3 wins,0,3,0,3
664,Drinking Buddies,1 win & 4 nominations.,0,1,4,5
665,Safe Haven,3 wins & 7 nominations.,0,3,7,10
666,American Hustle,Nominated for 10 Oscars. Another 69 wins & 217 nominations.,10,69,217,296
667,Jimi: All Is by My Side,1 win & 10 nominations.,0,1,10,11
668,Jobs,2 nominations.,0,0,2,2
669,Romeo & Juliet,,0,0,0,0
670,Saving Mr. Banks,Nominated for 1 Oscar. 13 wins & 74 nominations total,1,13,74,88
671,Scary Movie 5,5 nominations,0,0,5,5
672,Se levanta el viento,,0,0,0,0
673,Short Term 12,37 wins & 71 nominations,0,37,71,108
674,Trance,3 wins & 3 nominations.,0,3,3,6
675,Don Jon,2 wins & 27 nominations,0,2,27,29
676,Tracks,2 wins & 18 nominations,0,2,18,20
677,Dom Hemingway,2 nominations.,0,0,2,2
678,Ida,Won 1 Oscar. 68 wins & 92 nominations total,1,68,92,161
679,Dallas Buyers Club,Won 3 Oscars. 84 wins & 86 nominations total,3,84,86,173
680,Identity Thief,1 win & 9 nominations.,0,1,9,10
681,Turbo,1 win & 13 nominations total,0,1,13,14
682,Inside Llewyn Davis,Nominated for 2 Oscars. Another 46 wins & 172 nominations.,2,46,172,220
683,Iron Man 3,Nominated for 1 Oscar. Another 20 wins & 62 nominations.,1,20,62,83
684,Anna,1 nomination.,0,0,1,1
685,The World's End,4 wins & 27 nominations,0,4,27,31
686,The Congress,10 wins & 12 nominations,0,10,12,22
687,The Conjuring,15 wins & 22 nominations.,0,15,22,37
688,Charlie Countryman,2 nominations.,0,0,2,2
689,The Croods,Nominated for 1 Oscar. 5 wins & 46 nominations total,1,5,46,52
690,Instructions Not Included,1 nomination.,0,0,1,1
691,The To Do List,,0,0,0,0
692,Carrie,Nominated for 2 Oscars. Another 3 wins & 6 nominations.,2,3,6,11
693,Insidious: Chapter 2,16 nominations.,0,0,16,16
694,The Double,1 win & 11 nominations.,0,1,11,12
695,Captain Phillips,Nominated for 6 Oscars. 16 wins & 154 nominations total,6,16,154,176
696,August: Osage County,Nominated for 2 Oscars. Another 16 wins & 63 nominations.,2,16,63,81
697,The East,1 win & 7 nominations,0,1,7,8
698,Austenland,1 nomination.,0,0,1,1
699,The Tale of the Princess Kaguya,,0,0,0,0
700,The Family,1 nomination.,0,0,1,1
701,The Fifth Estate,2 wins & 3 nominations.,0,2,3,5
702,CBGB,,0,0,0,0
703,The Spectacular Now,9 wins & 32 nominations.,0,9,32,41
704,Broken City,1 win.,0,1,0,1
705,The Grandmaster,,0,0,0,0
706,The Great Beauty,Won 1 Oscar. Another 59 wins & 77 nominations.,1,59,77,137
707,12 Years a Slave,Won 3 Oscars. Another 240 wins & 336 nominations.,3,240,336,579
708,The Canyons,5 wins & 2 nominations.,0,5,2,7
709,The Call,1 win & 11 nominations,0,1,11,12
710,The 100 Year-Old Man Who Climbed Out the Window and Disappeared,Nominated for 1 Oscar. Another 6 wins & 10 nominations.,1,6,10,17
711,Joe,4 wins & 9 nominations,0,4,9,13
712,S�lo Dios perdona,,0,0,0,0
713,S�lo los amantes sobreviven,,0,0,0,0
714,In Secret,1 nomination.,0,0,1,1
715,The Wolverine,2 wins & 11 nominations,0,2,11,13
716,Temptation: Confessions of a Marriage Counselor,1 win & 5 nominations.,0,1,5,6
717,The Wolf of Wall Street,Nominated for 5 Oscars. Another 37 wins & 174 nominations.,5,37,174,216
718,Contracted,3 nominations.,0,0,3,3
719,Texas Chainsaw 3D,,0,0,0,0
720,In a World...,3 wins & 17 nominations.,0,3,17,20
721,The Book Thief,Nominated for 1 Oscar. Another 9 wins & 16 nominations.,1,9,16,26
722,The Way Way Back,5 wins & 30 nominations,0,5,30,35
723,Coherence,5 wins & 6 nominations.,0,5,6,11
724,The Art of the Steal,5 nominations.,0,0,5,5
725,Cloudy with a Chance of Meatballs 2,16 nominations.,0,0,16,16
726,The Best Man Holiday,3 wins & 15 nominations.,0,3,15,18
727,The Best Offer,,0,0,0,0
728,The Big Wedding,2 nominations.,0,0,2,2
729,The Bling Ring,4 wins & 7 nominations.,0,4,7,11
730,El pasado,1 win & 4 nominations.,0,1,4,5
731,Elysium,1 win & 10 nominations.,0,1,10,11
732,21 & Over,1 win & 5 nominations,0,1,5,6
733,Redemption,,0,0,0,0
734,Welcome to the Punch,2 wins.,0,2,0,2
735,Gravity,Won 7 Oscars. Another 230 wins & 187 nominations.,7,230,187,424
736,We're the Millers,4 wins & 17 nominations.,0,4,17,21
737,42,2 wins & 21 nominations.,0,2,21,23
738,We Are What We Are,5 wins & 11 nominations,0,5,11,16
739,Horns,4 wins & 4 nominations,0,4,4,8
740,Warm Bodies,2 wins & 10 nominations.,0,2,10,12
741,Gimme Shelter,3 wins & 1 nomination.,0,3,1,4
742,Monsters University,Nominated for 1 BAFTA Film Award. Another 9 wins & 57 nominations.,0,9,58,67
743,Walking with the Enemy,1 win.,0,1,0,1
744,Knights of Badassdom,2 nominations.,0,0,2,2
745,Movie 43,4 wins & 5 nominations,0,4,5,9
746,Gangster Squad,5 nominations.,0,0,5,5
747,G.I. Joe: Retaliation,1 win & 12 nominations.,0,1,12,13
748,Killing Season,,0,0,0,0
749,Fruitvale Station,36 wins & 57 nominations.,0,36,57,93
750,Nebraska,Nominated for 6 Oscars. Another 29 wins & 162 nominations.,6,29,162,197
751,How I Live Now,1 win & 8 nominations.,0,1,8,9
752,Ninfoman�a: primera parte,,0,0,0,0
753,Ninfoman�a: segunda parte,,0,0,0,0
754,47 Ronin,5 nominations.,0,0,5,5
755,Grown Ups 2,5 wins & 15 nominations.,0,5,15,20
756,Grudge Match,1 win & 1 nomination.,0,1,1,2
757,Labor Day,6 nominations,0,0,6,6
758,Her,Won 1 Oscar. Another 82 wins & 186 nominations.,1,82,186,269
759,Life of Crime,,0,0,0,0
760,Last Vegas,4 wins & 1 nomination,0,4,1,5
761,Locke,7 wins & 33 nominations.,0,7,33,40
762,Lone Survivor,Nominated for 2 Oscars. Another 6 wins & 14 nominations.,2,6,14,22
763,White House Down,3 wins & 9 nominations.,0,3,9,12
764,A Good Day to Die Hard,5 wins & 8 nominations.,0,5,8,13
765,World War Z,3 wins & 25 nominations.,0,3,25,28
766,Lovelace,1 win & 3 nominations.,0,1,3,4
767,A Haunted House,1 win & 1 nomination.,0,1,1,2
768,What If,,0,0,0,0
769,Machete Kills,3 nominations,0,0,3,3
770,La piel de Venus,,0,0,0,0
771,Hansel y Gretel: Cazadores de brujas,,0,0,0,0
772,Mam�,3 wins.,0,3,0,3
773,Man of Steel,7 wins & 46 nominations.,0,7,46,53
774,Man of Tai Chi,,0,0,0,0
775,Mandela: Long Walk to Freedom,Nominated for 1 Oscar. Another 14 wins & 34 nominations.,1,14,34,49
776,La noche de la expiaci�n,,0,0,0,0
777,Homefront,1 nomination.,0,0,1,1
778,Kill Your Darlings,5 wins & 13 nominations.,0,5,13,18
779,About Time,3 wins & 9 nominations.,0,3,9,12
780,V/H/S/2,1 win & 7 nominations.,0,1,7,8
781,Escape Plan,2 nominations,0,0,2,2
782,Fading Gigolo,2 wins & 1 nomination,0,2,1,3
783,Planes,5 nominations.,0,0,5,5
784,Ain't Them Bodies Saints,4 wins & 14 nominations.,0,4,14,18
785,Under the Skin,Nominated for 1 BAFTA Film Award. Another 23 wins & 110 nominations.,0,23,111,134
786,I Give It a Year,1 win & 1 nomination.,0,1,1,2
787,Evil Dead,6 wins & 19 nominations,0,6,19,25
788,Europa Report,1 win & 2 nominations,0,1,2,3
789,Prisoners,Nominated for 1 Oscar. Another 10 wins & 37 nominations.,1,10,37,48
790,Journey to the West,2 wins & 21 nominations.,0,2,21,23
791,Epic,2 wins & 21 nominations.,0,2,21,23
792,Afternoon Delight,1 win & 3 nominations.,0,1,3,4
793,I Spit on Your Grave 2,,0,0,0,0
794,Queen,22 wins & 18 nominations.,0,22,18,40
795,Un pasado imborrable,,0,0,0,0
796,R.I.P.D.,,0,0,0,0
797,Enough Said,Nominated for 1 Golden Globe. Another 8 wins & 37 nominations.,0,8,38,46
798,RED 2,3 nominations.,0,0,3,3
799,Enemigos id�nticos,,0,0,0,0
800,Ender's Game,1 win & 6 nominations.,0,1,6,7
801,Lee Daniels' The Butler,,0,0,0,0
802,Philomena,Nominated for 4 Oscars. Another 33 wins & 81 nominations.,4,33,81,118
803,The Smurfs 2,8 nominations,0,0,8,8
804,Now You See Me,1 win & 3 nominations,0,1,3,4
805,Young & Beautiful,Nominated for 2 Oscars. Another 11 wins & 6 nominations.,2,11,6,19
806,Oblivion,1 win & 17 nominations.,0,1,17,18
807,Oculus,3 wins & 17 nominations,0,3,17,20
808,Upstream Color,5 wins & 35 nominations.,0,5,35,40
809,Olympus Has Fallen,1 win & 5 nominations.,0,1,5,6
810,Out of the Furnace,1 win & 10 nominations,0,1,10,11
811,Oz the Great and Powerful,6 wins & 31 nominations.,0,6,31,37
812,Pacific Rim,Nominated for 1 BAFTA Film Award. Another 7 wins & 47 nominations.,0,7,48,55
813,Pain & Gain,4 nominations.,0,0,4,4
814,Palo Alto,4 nominations,0,0,4,4
815,Filth,9 wins & 14 nominations.,0,9,14,23
816,Percy Jackson: Sea of Monsters,3 wins & 5 nominations,0,3,5,8
817,Kick-Ass 2,1 win & 9 nominations,0,1,9,10
818,Paranoia,1 nomination.,0,0,1,1
819,Adore,,0,0,0,0
820,Adult World,1 nomination.,0,0,1,1
821,Parker,1 nomination.,0,0,1,1
822,Parkland,3 nominations.,0,0,3,3
823,Pawn,,0,0,0,0
824,After Earth,3 wins & 8 nominations.,0,3,8,11
825,Fast & Furious 6,10 wins & 22 nominations.,0,10,22,32
826,The Green Inferno,1 win & 6 nominations.,0,1,6,7
827,Riddick,2 nominations.,0,0,2,2
828,The Internship,2 nominations.,0,0,2,2
829,Before Midnight,Nominated for 1 Oscar. 20 wins & 63 nominations total,1,20,63,84
830,The Last Stand,1 win & 2 nominations.,0,1,2,3
831,Blue Is the Warmest Color,,0,0,0,0
832,Blue Jasmine,Won 1 Oscar. Another 55 wins & 81 nominations.,1,55,81,137
833,Belle,13 wins & 32 nominations.,0,13,32,45
834,The Last Days on Mars,4 nominations.,0,0,4,4
835,The Secret Life of Walter Mitty,5 wins & 18 nominations,0,5,18,23
836,The Mortal Instruments: City of Bones,6 wins & 11 nominations.,0,6,11,17
837,Bad Grandpa,Nominated for 1 Oscar. 1 win & 10 nominations total,1,1,10,12
838,The Hangover Part III,2 wins & 7 nominations.,0,2,7,9
839,The Hunger Games: Catching Fire,22 wins & 68 nominations.,0,22,68,90
840,The Sacrament,4 wins & 12 nominations.,0,4,12,16
841,Breathe In,3 nominations.,0,0,3,3
842,The Lunchbox,Nominated for 1 BAFTA Film Award. Another 28 wins & 37 nominations.,0,28,38,66
843,The Kings of Summer,5 wins & 10 nominations.,0,5,10,15
844,Begin Again,Nominated for 1 Oscar. Another 5 wins & 17 nominations.,1,5,17,23
845,Blue Ruin,7 wins & 20 nominations.,0,7,20,27
846,The Invisible Woman,Nominated for 1 Oscar. Another 1 win & 6 nominations.,1,1,6,8
847,The Immigrant,17 wins & 29 nominations.,0,17,29,46
848,The Hobbit: The Desolation of Smaug,Nominated for 3 Oscars. 19 wins & 90 nominations total,3,19,90,112
849,The Lone Ranger,Nominated for 2 Oscars. 5 wins & 20 nominations total,2,5,20,27
850,Blood Ties,,0,0,0,0
851,The Heat,7 wins & 16 nominations,0,7,16,23
852,The Incredible Burt Wonderstone,1 win & 4 nominations,0,1,4,5
853,The Place Beyond the Pines,5 wins & 22 nominations.,0,5,22,27
854,The Campaign,2 wins & 4 nominations.,0,2,4,6
855,The Perks of Being a Wallflower,19 wins & 50 nominations.,0,19,50,69
856,The Hunger Games,Nominated for 1 Golden Globe. Another 33 wins & 47 nominations.,0,33,48,81
857,The Possession,6 nominations.,0,0,6,6
858,Lockout,1 nomination,0,0,1,1
859,Trouble with the Curve,2 wins & 1 nomination.,0,2,1,3
860,The Cabin in the Woods,20 wins & 34 nominations.,0,20,34,54
861,The Magic of Belle Isle,1 nomination,0,0,1,1
862,People Like Us,,0,0,0,0
863,"Farewell, My Queen",6 wins & 12 nominations.,0,6,12,18
864,House at the End of the Street,1 win & 3 nominations,0,1,3,4
865,Chronicle,2 wins & 7 nominations.,0,2,7,9
866,Resident Evil: Retribution,2 wins & 6 nominations.,0,2,6,8
867,Struck by Lightning,1 win.,0,1,0,1
868,Stuck in Love,3 wins.,0,3,0,3
869,John Carter,2 wins & 8 nominations.,0,2,8,10
870,Aftershock,3 nominations.,0,0,3,3
871,Piranha 3DD,2 wins & 5 nominations.,0,2,5,7
872,Rise of the Guardians,14 wins & 32 nominations.,0,14,32,46
873,Moonrise Kingdom,Nominated for 1 Oscar. Another 36 wins & 121 nominations.,1,36,121,158
874,Zero Dark Thirty,Won 1 Oscar. Another 84 wins & 173 nominations.,1,84,173,258
875,ParaNorman,Nominated for 1 Oscar. 19 wins & 46 nominations total,1,19,46,66
876,If I Were You,4 wins & 13 nominations.,0,4,13,17
877,The Hunt,Nominated for 1 Oscar. Another 37 wins & 69 nominations.,1,37,69,107
878,Rock of Ages,2 wins & 8 nominations.,0,2,8,10
879,Madagascar 3: Europe's Most Wanted,3 wins & 20 nominations,0,3,20,23
880,Brave,Won 1 Oscar. 20 wins & 48 nominations total,1,20,48,69
881,Starlet,6 wins & 6 nominations.,0,6,6,12
882,Think Like a Man,3 wins & 14 nominations,0,3,14,17
883,Universal Soldier: Day of Reckoning,,0,0,0,0
884,Lincoln,Won 2 Oscars. 108 wins & 252 nominations total,2,108,252,362
885,Ruby Sparks,1 win & 11 nominations,0,1,11,12
886,The Paperboy,5 wins & 12 nominations.,0,5,12,17
887,Stand Up Guys,,0,0,0,0
888,This Is 40,2 wins & 11 nominations.,0,2,11,13
889,Paranormal Activity 4,2 wins,0,2,0,2
890,Parental Guidance,1 win & 4 nominations.,0,1,4,5
891,The Pirates! Band of Misfits,,0,0,0,0
892,Dark Shadows,2 wins & 13 nominations.,0,2,13,15
893,Robot & Frank,2 wins & 6 nominations.,0,2,6,8
894,Kon-Tiki,Nominated for 1 Oscar. Another 12 wins & 13 nominations.,1,12,13,26
895,Chasing Mavericks,,0,0,0,0
896,The Company You Keep,2 wins & 1 nomination.,0,2,1,3
897,Step Up Revolution,1 nomination,0,0,1,1
898,"Pasi�n, un asesinato perfecto",,0,0,0,0
899,The Twilight Saga: Breaking Dawn - Part 2,21 wins & 15 nominations.,0,21,15,36
900,Ice Age: Continental Drift,2 wins & 11 nominations.,0,2,11,13
901,Hotel Transylvania,2 wins & 15 nominations.,0,2,15,17
902,Stolen,,0,0,0,0
903,Looper,18 wins & 47 nominations.,0,18,47,65
904,The Collection,,0,0,0,0
905,The Cold Light of Day,2 nominations.,0,0,2,2
906,Chernobyl Diaries,1 nomination,0,0,1,1
907,Pitch Perfect,7 wins & 20 nominations,0,7,20,27
908,Lore,34 wins & 34 nominations.,0,34,34,68
909,The Sessions,Nominated for 1 Oscar. Another 18 wins & 63 nominations.,1,18,63,82
910,The Words,1 win & 3 nominations.,0,1,3,4
911,The Angels' Share,7 wins & 10 nominations.,0,7,10,17
912,Alex Cross,4 nominations,0,0,4,4
913,Red Dawn,1 win & 4 nominations.,0,1,4,5
914,Talaash,7 wins & 16 nominations,0,7,16,23
915,Prometheus,Nominated for 1 Oscar. Another 6 wins & 46 nominations.,1,6,46,53
916,Magic Mike,9 wins & 14 nominations,0,9,14,23
917,The Amazing Spider-Man,2 wins & 31 nominations.,0,2,31,33
918,The ABCs of Death,2 wins & 1 nomination.,0,2,1,3
919,Compliance,7 wins & 35 nominations.,0,7,35,42
920,Protegiendo al enemigo,,0,0,0,0
921,The Master,Nominated for 3 Oscars. Another 75 wins & 184 nominations.,3,75,184,262
922,Madea's Witness Protection,1 win & 5 nominations,0,1,5,6
923,That's My Boy,5 wins & 10 nominations.,0,5,10,15
924,The Apparition,1 nomination.,0,0,1,1
925,Thanks for Sharing,2 nominations.,0,0,2,2
926,A Hijacking,16 wins & 26 nominations.,0,16,26,42
927,Hyde Park on Hudson,Nominated for 1 Golden Globe. Another 1 win & 4 nominations.,0,1,5,6
928,En la casa,,0,0,0,0
929,The Samaritan,4 nominations.,0,0,4,4
930,Contraband,1 win.,0,1,0,1
931,Quartet,Nominated for 1 Golden Globe. Another 4 wins & 4 nominations.,0,4,5,9
932,Cosm�polis,,0,0,0,0
933,Terror en Silent Hill 2: la revelaci�n,,0,0,0,0
934,Ted,Nominated for 1 Oscar. Another 13 wins & 27 nominations.,1,13,27,41
935,The Woman in Black,5 wins & 14 nominations.,0,5,14,19
936,End of Watch,3 wins & 10 nominations,0,3,10,13
937,English Vinglish,12 wins & 19 nominations.,0,12,19,31
938,Bel Ami,,0,0,0,0
939,Red Lights,2 nominations.,0,0,2,2
940,John Dies at the End,2 wins & 6 nominations.,0,2,6,8
941,Twice Born,7 nominations.,0,0,7,7
942,El c�rculo roto,,0,0,0,0
943,The Bourne Legacy,1 win & 11 nominations,0,1,11,12
944,The Dark Knight Rises,38 wins & 103 nominations total,0,38,103,141
945,Renoir,3 wins & 11 nominations.,0,3,11,14
946,Killing Them Softly,3 wins & 9 nominations,0,3,9,12
947,Underworld Awakening,1 win,0,1,0,1
948,Journey 2: The Mysterious Island,7 wins & 4 nominations.,0,7,4,11
949,The Odd Life of Timothy Green,1 win & 8 nominations.,0,1,8,9
950,What Maisie Knew,3 wins & 8 nominations,0,3,8,11
951,A Late Quartet,1 win & 2 nominations,0,1,2,3
952,The Hobbit: An Unexpected Journey,Nominated for 3 Oscars. Another 11 wins & 72 nominations.,3,11,72,86
953,21 Jump Street,11 wins & 21 nominations,0,11,21,32
954,Being Flynn,1 win.,0,1,0,1
955,The Watch,2 nominations,0,0,2,2
956,The Vow,3 wins & 14 nominations.,0,3,14,17
957,The Bay,1 win & 1 nomination.,0,1,1,2
958,Battleship,4 wins & 16 nominations,0,4,16,20
959,What to Expect When You're Expecting,12 nominations.,0,0,12,12
960,Argo,Won 3 Oscars. Another 91 wins & 155 nominations.,3,91,155,249
961,Cloud Atlas,15 wins & 79 nominations.,0,15,79,94
962,Man on a Ledge,1 nomination.,0,0,1,1
963,Premium Rush,1 win & 4 nominations.,0,1,4,5
964,The Man with the Iron Fists,4 nominations,0,0,4,4
965,Red Tails,2 wins & 9 nominations.,0,2,9,11
966,Arbitrage,4 wins & 5 nominations.,0,4,5,9
967,Joyful Noise,1 nomination,0,0,1,1
968,Big Miracle,1 nomination.,0,0,1,1
969,Kahaani,23 wins & 18 nominations,0,23,18,41
970,Life of Pi,Won 4 Oscars. 81 wins & 134 nominations total,4,81,134,219
971,Vamps,,0,0,0,0
972,To the Wonder,5 wins & 10 nominations,0,5,10,15
973,Sinister,3 wins & 14 nominations,0,3,14,17
974,To Rome with Love,2 wins & 5 nominations.,0,2,5,7
975,Byzantium,2 wins & 7 nominations.,0,2,7,9
976,Wreck-It Ralph,Nominated for 1 Oscar. Another 33 wins & 41 nominations.,1,33,41,75
977,The Five-Year Engagement,,0,0,0,0
978,Beasts of the Southern Wild,Nominated for 4 Oscars. Another 90 wins & 130 nominations.,4,90,130,224
979,B�squeda implacable 2,,0,0,0,0
980,The First Time,1 nomination,0,0,1,1
981,Mirror Mirror,Nominated for 1 Oscar. Another 2 wins & 8 nominations.,1,2,8,11
982,The Guilt Trip,1 nomination.,0,0,1,1
983,ATM,,0,0,0,0
984,Skyfall,Won 2 Oscars. Another 65 wins & 123 nominations.,2,65,123,190
985,Into the White,3 nominations,0,0,3,3
986,The Reluctant Fundamentalist,3 wins,0,3,0,3
987,About Cherry,,0,0,0,0
988,Gone,,0,0,0,0
989,No,Nominated for 1 Oscar. Another 13 wins & 20 nominations.,1,13,20,34
990,The Sweeney,5 nominations,0,0,5,5
991,Frankenweenie,Nominated for 1 Oscar. Another 11 wins & 49 nominations.,1,11,49,61
992,Frances Ha,1 win & 49 nominations.,0,1,49,50
993,The Expendables 2,4 wins & 5 nominations.,0,4,5,9
994,The Lucky One,5 wins & 7 nominations.,0,5,7,12
995,No One Lives,1 nomination.,0,0,1,1
996,Smashed,10 nominations.,0,0,10,10
997,Abraham Lincoln: Vampire Hunter,1 nomination,0,0,1,1
998,Save the Date,3 wins & 2 nominations,0,3,2,5
999,Todo lo que necesitas es amor,,0,0,0,0
1000,Fun Size,,0,0,0,0
1001,Savages,7 nominations,0,0,7,7
1002,[REC] 3: Genesis,,0,0,0,0
1003,Lawless,1 win & 8 nominations,0,1,8,9
1004,Disconnect,,0,0,0,0
1005,Shadow Dancer,8 wins & 9 nominations.,0,8,9,17
1006,Lay the Favorite,1 nomination.,0,0,1,1
1007,Total Recall,Won 1 Oscar. 7 wins & 16 nominations total,1,7,16,24
1008,Django Unchained,Won 2 Oscars. Another 55 wins & 158 nominations.,2,55,158,215
1009,The Lords of Salem,1 win & 3 nominations.,0,1,3,4
1010,Ginger & Rosa,,0,0,0,0
1011,Hit and Run,1 win,0,1,0,1
1012,Bachelorette,1 win & 2 nominations,0,1,2,3
1013,Seven Psychopaths,3 wins & 21 nominations.,0,3,21,24
1014,Girl Most Likely,,0,0,0,0
1015,Hitchcock,Nominated for 1 Oscar. 5 wins & 29 nominations total,1,5,29,35
1016,A Thousand Words,3 nominations.,0,0,3,3
1017,Silver Linings Playbook,Won 1 Oscar. Another 88 wins & 148 nominations.,1,88,148,237
1018,Mud,15 wins & 39 nominations.,0,15,39,54
1019,Wanderlust,1 win.,0,1,0,1
1020,Diary of a Wimpy Kid: Dog Days,2 wins & 7 nominations,0,2,7,9
1021,A Royal Affair,Nominated for 1 Oscar. Another 21 wins & 37 nominations.,1,21,37,59
1022,American Reunion,1 win & 4 nominations,0,1,4,5
1023,The Lorax,4 wins & 8 nominations.,0,4,8,12
1024,Bullet to the Head,1 nomination,0,0,1,1
1025,The Impossible,Nominated for 1 Oscar. Another 28 wins & 68 nominations.,1,28,68,97
1026,Sightseers,11 wins & 18 nominations,0,11,18,29
1027,Seeking a Friend for the End of the World,3 nominations,0,0,3,3
1028,Furia de Titanes 2,,0,0,0,0
1029,Amour,Won 1 Oscar. Another 82 wins & 107 nominations.,1,82,107,190
1030,Snow White and the Huntsman,Nominated for 2 Oscars. 13 wins & 33 nominations total,2,13,33,48
1031,Tim and Eric's Billion Dollar Movie,1 nomination.,0,0,1,1
1032,On the Road,2 wins & 4 nominations,0,2,4,6
1033,The Iceman,2 wins,0,2,0,2
1034,Act of Valor,1 win & 7 nominations.,0,1,7,8
1035,Jack Reacher,1 win & 6 nominations.,0,1,6,7
1036,Men in Black 3,1 win & 13 nominations.,0,1,13,14
1037,This Means War,1 win & 6 nominations,0,1,6,7
1038,Hope Springs,Nominated for 1 Golden Globe. Another 2 wins & 4 nominations.,0,2,5,7
1039,Liberal Arts,7 nominations,0,0,7,7
1040,One for the Money,1 win & 1 nomination.,0,1,1,2
1041,The Dictator,1 win & 1 nomination.,0,1,1,2
1042,The Three Stooges,4 nominations,0,0,4,4
1043,V/H/S,5 nominations,0,0,5,5
1044,Casa de mi Padre,3 wins & 8 nominations.,0,3,8,11
1045,Rust and Bone,,0,0,0,0
1046,Dredd,2 wins & 14 nominations.,0,2,14,16
1047,Spring Breakers,10 wins & 36 nominations,0,10,36,46
1048,Safety Not Guaranteed,8 wins & 18 nominations.,0,8,18,26
1049,Not Fade Away,3 wins & 3 nominations.,0,3,3,6
1050,The Raven,5 nominations,0,0,5,5
1051,La bicicleta verde,,0,0,0,0
1052,Flight,Nominated for 2 Oscars. Another 15 wins & 43 nominations.,2,15,43,60
1053,Upside Down,6 nominations.,0,0,6,6
1054,Celeste & Jesse Forever,7 wins & 12 nominations.,0,7,12,19
1055,At Any Price,1 nomination,0,0,1,1
1056,The Devil Inside,2 wins & 3 nominations.,0,2,3,5
1057,Dracula 3D,3 nominations,0,0,3,3
1058,"For a Good Time, Call...",,0,0,0,0
1059,Here Comes the Boom,3 nominations.,0,0,3,3
1060,LOL,1 nomination,0,0,1,1
1061,Diary of a Wimpy Kid: Rodrick Rules,2 wins & 5 nominations,0,2,5,7
1062,Young Adult,Nominated for 1 Golden Globe. Another 3 wins & 32 nominations.,0,3,33,36
1063,The Innkeepers,2 wins & 5 nominations.,0,2,5,7
1064,Elles,1 win.,0,1,0,1
1065,Kill List,3 wins & 18 nominations.,0,3,18,21
1066,"Crazy, Stupid, Love.",4 wins & 23 nominations,0,4,23,27
1067,Another Earth,7 wins & 13 nominations,0,7,13,20
1068,The Inbetweeners Movie,,0,0,0,0
1069,Don 2,8 wins & 7 nominations.,0,8,7,15
1070,360,3 nominations.,0,0,3,3
1071,Winnie the Pooh,2 wins & 25 nominations,0,2,25,27
1072,50/50,Nominated for 2 Golden Globes. Another 12 wins & 26 nominations.,0,12,28,40
1073,The Ides of March,Nominated for 1 Oscar. Another 9 wins & 34 nominations.,1,9,34,44
1074,Rockstar,36 wins & 18 nominations,0,36,18,54
1075,Spy Kids 4: All the Time in the World,6 nominations,0,0,6,6
1076,The Intouchables,Nominated for 1 BAFTA Film Award. Another 38 wins & 39 nominations.,0,38,40,78
1077,Like Crazy,9 wins & 7 nominations,0,9,7,16
1078,Coriolanus,Nominated for 1 BAFTA Film Award. Another 10 wins & 17 nominations.,0,10,18,28
1079,Sherlock Holmes: A Game of Shadows,3 wins & 11 nominations.,0,3,11,14
1080,Limitless,2 wins & 8 nominations.,0,2,8,10
1081,The Muppets,Won 1 Oscar. Another 16 wins & 43 nominations.,1,16,43,60
1082,Rampart,2 wins & 6 nominations,0,2,6,8
1083,Tower Heist,3 nominations.,0,0,3,3
1084,Hugo,Won 5 Oscars. 61 wins & 192 nominations total,5,61,192,258
1085,Cowboys & Aliens,2 wins & 2 nominations.,0,2,2,4
1086,Larry Crowne,3 nominations.,0,0,3,3
1087,Dolphin Tale,4 wins & 4 nominations.,0,4,4,8
1088,Kung Fu Panda 2,Nominated for 1 Oscar. 5 wins & 47 nominations total,1,5,47,53
1089,Rango,Won 1 Oscar. Another 45 wins & 25 nominations.,1,45,25,71
1090,Drive,Nominated for 1 Oscar. Another 79 wins & 179 nominations.,1,79,179,259
1091,Take Shelter,42 wins & 46 nominations.,0,42,46,88
1092,Courageous,2 wins & 3 nominations.,0,2,3,5
1093,Machine Gun Preacher,2 nominations,0,0,2,2
1094,Real Steel,Nominated for 1 Oscar. Another 2 wins & 5 nominations.,1,2,5,8
1095,Take This Waltz,3 wins & 19 nominations.,0,3,19,22
1096,Anonymous,Nominated for 1 Oscar. 7 wins & 12 nominations total,1,7,12,20
1097,Alvin and the Chipmunks: Chipwrecked,2 wins & 1 nomination.,0,2,1,3
1098,Thor,5 wins & 30 nominations.,0,5,30,35
1099,Rio,Nominated for 1 Oscar. Another 3 wins & 30 nominations.,1,3,30,34
1100,Bad Teacher,6 wins & 4 nominations.,0,6,4,10
1101,Drive Angry,1 win & 6 nominations.,0,1,6,7
1102,The Iron Lady,Won 2 Oscars. Another 23 wins & 47 nominations.,2,23,47,72
1103,Sleeping Beauty,Nominated for 1 Oscar. 4 wins & 6 nominations total,1,4,6,11
1104,El esp�a que sab�a demasiado,,0,0,0,0
1105,Scream 4,1 win & 6 nominations.,0,1,6,7
1106,Hop,2 nominations.,0,0,2,2
1107,Super 8,11 wins & 70 nominations.,0,11,70,81
1108,Alps: Los suplantadores,,0,0,0,0
1109,La piel que habito,28 wins & 69 nominations total,0,28,69,97
1110,The Mechanic,1 nomination.,0,0,1,1
1111,Bernie,10 wins & 19 nominations.,0,10,19,29
1112,Sanctum,1 win & 1 nomination.,0,1,1,2
1113,A Good Old Fashioned Orgy,,0,0,0,0
1114,House of Tolerance,6 wins & 15 nominations.,0,6,15,21
1115,Transformers: Dark of the Moon,Nominated for 3 Oscars. Another 10 wins & 39 nominations.,3,10,39,52
1116,Sucker Punch,1 win & 11 nominations,0,1,11,12
1117,Something Borrowed,5 nominations,0,0,5,5
1118,Beastly,1 win & 1 nomination.,0,1,1,2
1119,X-Men: First Class,21 wins & 39 nominations.,0,21,39,60
1120,30 minutos o menos,,0,0,0,0
1121,Wuthering Heights,Won 1 Oscar. Another 7 wins & 8 nominations.,1,7,8,16
1122,Salmon Fishing in the Yemen,6 nominations.,0,0,6,6
1123,Take Me Home Tonight,1 nomination.,0,0,1,1
1124,Kill the Irishman,1 nomination,0,0,1,1
1125,Silent House,1 win & 2 nominations.,0,1,2,3
1126,A Dangerous Method,18 wins & 28 nominations,0,18,28,46
1127,Take Me Home,4 wins.,0,4,0,4
1128,Horrible Bosses,3 wins & 13 nominations.,0,3,13,16
1129,Red Riding Hood,5 nominations.,0,0,5,5
1130,Straw Dogs,Nominated for 1 Oscar. Another 1 win & 1 nomination.,1,1,1,3
1131,Red State,3 wins & 8 nominations,0,3,8,11
1132,Hobo with a Shotgun,1 win & 4 nominations.,0,1,4,5
1133,Source Code,1 win & 8 nominations.,0,1,8,9
1134,Detachment,8 wins & 4 nominations.,0,8,4,12
1135,Seeking Justice,1 nomination.,0,0,1,1
1136,Killer Joe,9 wins & 21 nominations,0,9,21,30
1137,You're Next,11 wins & 20 nominations.,0,11,20,31
1138,Sound of My Voice,1 win & 8 nominations,0,1,8,9
1139,Harry Potter and the Deathly Hallows: Part 2,Nominated for 3 Oscars. Another 46 wins & 91 nominations.,3,46,91,140
1140,The Human Centipede II (Full Sequence),1 win & 5 nominations.,0,1,5,6
1141,Soul Surfer,2 wins & 12 nominations.,0,2,12,14
1142,Killer Elite,2 wins & 8 nominations,0,2,8,10
1143,This Must Be the Place,19 wins & 17 nominations.,0,19,17,36
1144,Rise of the Planet of the Apes,Nominated for 1 Oscar. 21 wins & 43 nominations total,1,21,43,65
1145,Season of the Witch,2 nominations.,0,0,2,2
1146,Dream House,2 nominations,0,0,2,2
1147,The Hunter,4 wins & 23 nominations.,0,4,23,27
1148,Jumping the Broom,3 wins & 13 nominations.,0,3,13,16
1149,Weekend,23 wins & 22 nominations.,0,23,22,45
1150,Fast Five,9 wins & 21 nominations.,0,9,21,30
1151,The Decoy Bride,1 win & 1 nomination.,0,1,1,2
1152,Immortals,1 win & 6 nominations.,0,1,6,7
1153,The Deep Blue Sea,4 wins & 13 nominations,0,4,13,17
1154,Catch .44,,0,0,0,0
1155,The Descendants,Won 1 Oscar. Another 64 wins & 147 nominations.,1,64,147,212
1156,The Devil's Double,4 nominations.,0,0,4,4
1157,One Day,1 win & 2 nominations.,0,1,2,3
1158,Goon,1 win & 13 nominations.,0,1,13,14
1159,The Rite,1 win & 5 nominations,0,1,5,6
1160,Cars 2,1 win & 19 nominations,0,1,19,20
1161,We Need to Talk About Kevin,26 wins & 66 nominations total,0,26,66,92
1162,The Dilemma,1 nomination.,0,0,1,1
1163,Flypaper,,0,0,0,0
1164,The Thing,3 nominations.,0,0,3,3
1165,Footloose,Nominated for 2 Oscars. 1 win & 6 nominations total,2,1,6,9
1166,Zookeeper,1 win & 2 nominations,0,1,2,3
1167,Atlas Shrugged: Part I,1 win.,0,1,0,1
1168,Attack the Block,19 wins & 39 nominations total,0,19,39,58
1169,Melancol�a,,0,0,0,0
1170,J. Edgar,5 wins & 17 nominations,0,5,17,22
1171,Cedar Rapids,1 win & 4 nominations.,0,1,4,5
1172,The Roommate,7 nominations,0,0,7,7
1173,The Change-Up,1 nomination,0,0,1,1
1174,Battle Los Angeles,1 win & 4 nominations.,0,1,4,5
1175,"Peace, Love, & Misunderstanding",1 win.,0,1,0,1
1176,Paul,2 wins & 9 nominations.,0,2,9,11
1177,Zindagi Na Milegi Dobara,32 wins & 22 nominations.,0,32,22,54
1178,The Raid: Redemption,8 wins & 13 nominations.,0,8,13,21
1179,The Twilight Saga: Breaking Dawn - Part 1,11 wins & 22 nominations.,0,11,22,33
1180,Our Idiot Brother,,0,0,0,0
1181,Paranormal Activity 3,1 win & 6 nominations.,0,1,6,7
1182,Final Destination 5,2 wins & 6 nominations,0,2,6,8
1183,Chalet Girl,1 nomination.,0,0,1,1
1184,The Tree of Life,Nominated for 3 Oscars. 116 wins & 129 nominations total,3,116,129,248
1185,Green Lantern,3 wins & 6 nominations.,0,3,6,9
1186,The Ledge,1 nomination.,0,0,1,1
1187,Jack and Jill,14 wins & 5 nominations,0,14,5,19
1188,The Darkest Hour,1 nomination.,0,0,1,1
1189,In Time,2 nominations.,0,0,2,2
1190,The Hangover Part II,5 wins & 18 nominations.,0,5,18,23
1191,North Sea Texas,,0,0,0,0
1192,Moneyball,Nominated for 6 Oscars. Another 29 wins & 76 nominations.,6,29,76,111
1193,Bullhead,1 win.,0,1,0,1
1194,A Very Harold & Kumar 3D Christmas,1 nomination,0,0,1,1
1195,Gnomeo & Juliet,1 win & 12 nominations.,0,1,12,13
1196,Mission: Impossible - Ghost Protocol,5 wins & 30 nominations.,0,5,30,35
1197,Violet & Daisy,4 wins & 12 nominations.,0,4,12,16
1198,A Separation,1 win & 4 nominations.,0,1,4,5
1199,10 Years,,0,0,0,0
1200,Mr. Popper's Penguins,1 win & 3 nominations,0,1,3,4
1201,My Week with Marilyn,Nominated for 2 Oscars. Another 18 wins & 62 nominations.,2,18,62,82
1202,W.E.,Nominated for 1 Oscar. 4 wins & 6 nominations total,1,4,6,11
1203,The Smurfs,2 wins & 8 nominations,0,2,8,10
1204,Ghost Rider: Spirit of Vengeance,4 nominations.,0,0,4,4
1205,The Snowtown Murders,,0,0,0,0
1206,�Sabes qui�n viene?,,0,0,0,0
1207,The Green Hornet,4 wins & 7 nominations.,0,4,7,11
1208,Bridesmaids,Nominated for 2 Oscars. Another 25 wins & 70 nominations.,2,25,70,97
1209,The Grey,2 wins & 8 nominations.,0,2,8,10
1210,War Horse,Nominated for 6 Oscars. Another 15 wins & 71 nominations.,6,15,71,92
1211,God Bless America,5 nominations,0,0,5,5
1212,The Eagle,1 nomination.,0,0,1,1
1213,In the Land of Blood and Honey,6 wins & 7 nominations,0,6,7,13
1214,We Bought a Zoo,1 win & 8 nominations.,0,1,8,9
1215,Captain America: The First Avenger,4 wins & 46 nominations.,0,4,46,50
1216,"Big Mommas: Like Father, Like Son",4 nominations.,0,0,4,4
1217,The Sitter,2 nominations.,0,0,2,2
1218,Midnight in Paris,Won 1 Oscar. Another 25 wins & 103 nominations.,1,25,103,129
1219,No Strings Attached,2 wins & 6 nominations.,0,2,6,8
1220,Intruders,1 win & 5 nominations.,0,1,5,6
1221,Water for Elephants,3 wins & 13 nominations,0,3,13,16
1222,The Lincoln Lawyer,1 nomination.,0,0,1,1
1223,From Up on Poppy Hill,,0,0,0,0
1224,Abduction,2 wins & 3 nominations.,0,2,3,5
1225,New Year's Eve,2 wins & 8 nominations.,0,2,8,10
1226,Friends with Benefits,1 win & 5 nominations.,0,1,5,6
1227,Friends with Kids,2 nominations.,0,0,2,2
1228,The Flowers of War,Nominated for 1 Golden Globe. Another 15 wins & 15 nominations.,0,15,16,31
1229,Warrior,Nominated for 1 Oscar. Another 5 wins & 21 nominations.,1,5,21,27
1230,Fright Night,2 wins & 8 nominations.,0,2,8,10
1231,Butter,,0,0,0,0
1232,The Help,Won 1 Oscar. Another 78 wins & 121 nominations.,1,78,121,200
1233,Shame,50 wins & 94 nominations total,0,50,94,144
1234,Aislados,5 wins & 4 nominations.,0,5,4,9
1235,I Am Number Four,1 win & 1 nomination,0,1,1,2
1236,The Adjustment Bureau,1 win & 9 nominations.,0,1,9,10
1237,Margin Call,Nominated for 1 Oscar. 8 wins & 24 nominations total,1,8,24,33
1238,The Rum Diary,2 wins & 4 nominations.,0,2,4,6
1239,Margaret,9 wins & 18 nominations.,0,9,18,27
1240,A Little Bit of Heaven,,0,0,0,0
1241,Pirates of the Caribbean: On Stranger Tides,3 wins & 31 nominations.,0,3,31,34
1242,Arthur,3 wins & 6 nominations.,0,3,6,9
1243,Apollo 18,1 win & 2 nominations.,0,1,2,3
1244,Shark Night 3D,,0,0,0,0
1245,Agentes Secretos,,0,0,0,0
1246,Johnny English Reborn,4 nominations,0,0,4,4
1247,Colombiana,2 wins & 5 nominations.,0,2,5,7
1248,Extremely Loud & Incredibly Close,Nominated for 2 Oscars. Another 8 wins & 23 nominations.,2,8,23,33
1249,The Big Year,1 win.,0,1,0,1
1250,The Guard,17 wins & 28 nominations total,0,17,28,45
1251,Hall Pass,,0,0,0,0
1252,The Best Exotic Marigold Hotel,4 wins & 22 nominations total,0,4,22,26
1253,Albert Nobbs,Nominated for 3 Oscars. Another 19 wins & 39 nominations.,3,19,39,61
1254,The Beaver,2 wins & 12 nominations.,0,2,12,14
1255,Prom,1 nomination.,0,0,1,1
1256,Princesa por accidente,,0,0,0,0
1257,The Art of Getting By,1 win & 2 nominations.,0,1,2,3
1258,What's Your Number?,1 win,0,1,0,1
1259,Hanna,8 wins & 26 nominations.,0,8,26,34
1260,Conan the Barbarian,2 wins & 9 nominations.,0,2,9,11
1261,The Artist,Won 5 Oscars. 162 wins & 204 nominations total,5,162,204,371
1262,Happy Feet Two,3 wins & 9 nominations,0,3,9,12
1263,Puncture,2 wins.,0,2,0,2
1264,Texas Killing Fields,4 wins & 3 nominations.,0,4,3,7
1265,Perfect Sense,3 wins & 3 nominations.,0,3,3,6
1266,Contagion,2 wins & 14 nominations.,0,2,14,16
1267,Puss in Boots,Nominated for 1 Oscar. 9 wins & 43 nominations total,1,9,43,53
1268,Martha Marcy May Marlene,22 wins & 74 nominations.,0,22,74,96
1269,Hysteria,2 nominations,0,0,2,2
1270,Just Go with It,5 wins & 13 nominations.,0,5,13,18
1271,Your Highness,1 win & 3 nominations,0,1,3,4
1272,Ramona and Beezus,1 win & 4 nominations,0,1,4,5
1273,The Killer Inside Me,2 wins & 5 nominations,0,2,5,7
1274,The King's Speech,Won 4 Oscars. 108 wins & 206 nominations total,4,108,206,318
1275,A Nightmare on Elm Street,4 wins & 5 nominations.,0,4,5,9
1276,Going the Distance,,0,0,0,0
1277,Scott Pilgrim vs. the World,17 wins & 64 nominations.,0,17,64,81
1278,Vampires Suck,7 nominations,0,0,7,7
1279,The Runaways,6 nominations.,0,0,6,6
1280,Elite Squad: The Enemy Within,,0,0,0,0
1281,Let Me In,14 wins & 28 nominations.,0,14,28,42
1282,Frankie & Alice,6 nominations.,0,0,6,6
1283,RED,4 wins & 19 nominations,0,4,19,23
1284,Sex and the City 2,8 wins & 9 nominations.,0,8,9,17
1285,Hesher,1 win & 1 nomination.,0,1,1,2
1286,The Kids Are All Right,Nominated for 4 Oscars. Another 29 wins & 129 nominations.,4,29,129,162
1287,Letters to Juliet,6 nominations,0,0,6,6
1288,Prince of Persia: The Sands of Time,1 win & 11 nominations.,0,1,11,12
1289,Saw 3D: The Final Chapter,,0,0,0,0
1290,The Losers,1 win & 7 nominations,0,1,7,8
1291,Four Lions,Won 1 BAFTA Film Award. Another 8 wins & 24 nominations.,0,9,24,33
1292,Never Let Me Go,8 wins & 27 nominations.,0,8,27,35
1293,Blue Valentine,Nominated for 1 Oscar. Another 9 wins & 55 nominations.,1,9,55,65
1294,Red Hill,6 nominations.,0,0,6,6
1295,MacGruber,2 nominations.,0,0,2,2
1296,Alice in Wonderland,Won 2 Oscars. Another 33 wins & 63 nominations.,2,33,63,98
1297,The Karate Kid,Nominated for 1 Oscar. Another 2 wins & 2 nominations.,1,2,2,5
1298,Furry Vengeance,1 win & 1 nomination,0,1,1,2
1299,My Soul to Take,1 nomination,0,0,1,1
1300,Beyond the Black Rainbow,5 wins.,0,5,0,5
1301,When in Rome,3 nominations.,0,0,3,3
1302,Don't Be Afraid of the Dark,4 nominations.,0,0,4,4
1303,Machete,2 wins & 6 nominations,0,2,6,8
1304,Nanny McPhee Returns,,0,0,0,0
1305,Legion,,0,0,0,0
1306,Valentine's Day,7 wins & 12 nominations.,0,7,12,19
1307,Happythankyoumoreplease,1 win & 3 nominations.,0,1,3,4
1308,Vanishing on 7th Street,,0,0,0,0
1309,Sepultado,,0,0,0,0
1310,Secretariat,3 wins & 6 nominations.,0,3,6,9
1311,Legend of the Guardians: The Owls of Ga'Hoole,4 wins & 23 nominations.,0,4,23,27
1312,Get Him to the Greek,14 nominations,0,0,14,14
1313,Waiting for Forever,1 win & 1 nomination.,0,1,1,2
1314,Wall Street: Money Never Sleeps,1 win & 4 nominations.,0,1,4,5
1315,Toy Story 3,Won 2 Oscars. Another 59 wins & 96 nominations.,2,59,96,157
1316,My Name Is Khan,23 wins & 26 nominations.,0,23,26,49
1317,Monsters,14 wins & 14 nominations total,0,14,14,28
1318,Secretos Peligrosos,,0,0,0,0
1319,A Little Help,2 nominations,0,0,2,2
1320,Hereafter,Nominated for 1 Oscar. Another 4 wins & 14 nominations.,1,4,14,19
1321,Paranormal Activity 2,1 win & 2 nominations.,0,1,2,3
1322,Gulliver's Travels,3 nominations,0,0,3,3
1323,Heartbreaker,,0,0,0,0
1324,Resident Evil: Afterlife,2 wins & 8 nominations.,0,2,8,10
1325,Trollhunter,12 wins & 13 nominations.,0,12,13,25
1326,Dylan Dog: Dead of Night,1 nomination.,0,0,1,1
1327,Piranha 3D,2 wins & 12 nominations.,0,2,12,14
1328,Little White Lies,,0,0,0,0
1329,Little Fockers,3 wins & 5 nominations,0,3,5,8
1330,Greenberg,2 wins & 15 nominations,0,2,15,17
1331,Green Zone,6 nominations.,0,0,6,6
1332,The Romantics,,0,0,0,0
1333,Wild Target,,0,0,0,0
1334,Made in Dagenham,3 wins & 17 nominations total,0,3,17,20
1335,Marmaduke,3 nominations.,0,0,3,3
1336,The Last Song,4 wins & 10 nominations,0,4,10,14
1337,Black Swan,Won 1 Oscar. 97 wins & 279 nominations total,1,97,279,377
1338,Welcome to the Rileys,2 wins & 3 nominations,0,2,3,5
1339,Easy A,9 wins & 21 nominations.,0,9,21,30
1340,Par�s en la Mira,,0,0,0,0
1341,Easy Money,,0,0,0,0
1342,Passion Play,,0,0,0,0
1343,Robin Hood,1 win & 14 nominations.,0,1,14,15
1344,Eat Pray Love,2 wins & 2 nominations,0,2,2,4
1345,Grown Ups,3 wins & 4 nominations.,0,3,4,7
1346,True Grit,Nominated for 10 Oscars. 38 wins & 169 nominations total,10,38,169,217
1347,Alpha and Omega,1 nomination,0,0,1,1
1348,Edge of Darkness,1 nomination,0,0,1,1
1349,London Boulevard,1 nomination.,0,0,1,1
1350,The Man from Nowhere,,0,0,0,0
1351,Due Date,7 nominations.,0,0,7,7
1352,Rubber,5 wins & 3 nominations.,0,5,3,8
1353,The Last Airbender,8 wins & 12 nominations.,0,8,12,20
1354,For Colored Girls,14 wins & 17 nominations.,0,14,17,31
1355,Biutiful,Nominated for 2 Oscars. Another 21 wins & 62 nominations.,2,21,62,85
1356,Salt,Nominated for 1 Oscar. Another 4 wins & 15 nominations.,1,4,15,20
1357,Remember Me,4 wins & 5 nominations,0,4,5,9
1358,The Last Circus,11 wins & 21 nominations.,0,11,21,32
1359,Predators,2 wins & 4 nominations,0,2,4,6
1360,Everything Must Go,1 nomination,0,0,1,1
1361,Harry Potter and the Deathly Hallows: Part 1,Nominated for 2 Oscars. Another 15 wins & 53 nominations.,2,15,53,70
1362,Heartbeats,,0,0,0,0
1363,El �ltimo exorcismo,,0,0,0,0
1364,Norwegian Wood,,0,0,0,0
1365,Faster,5 nominations,0,0,5,5
1366,Elektra Luxx,1 nomination,0,0,1,1
1367,Winter's Bone,Nominated for 4 Oscars. Another 63 wins & 127 nominations.,4,63,127,194
1368,Even the Rain,,0,0,0,0
1369,Hatchet II,4 nominations.,0,0,4,4
1370,Uncle Boonmee Who Can Recall His Past Lives,11 wins & 24 nominations.,0,11,24,35
1371,Twelve,1 nomination.,0,0,1,1
1372,Love Ranch,1 win & 1 nomination.,0,1,1,2
1373,Flipped,2 wins & 2 nominations,0,2,2,4
1374,All Good Things,1 nomination.,0,0,1,1
1375,Extraordinary Measures,1 win.,0,1,0,1
1376,Life as We Know It,2 nominations.,0,0,2,2
1377,Henry's Crime,,0,0,0,0
1378,Love & Other Drugs,2 wins & 1 nomination.,0,2,1,3
1379,Megamind,2 wins & 16 nominations.,0,2,16,18
1380,Guzaarish,9 wins & 21 nominations.,0,9,21,30
1381,Black Death,3 wins & 7 nominations.,0,3,7,10
1382,Repo Men,2 nominations,0,0,2,2
1383,Meek's Cutoff,7 wins & 14 nominations.,0,7,14,21
1384,Unstoppable,Nominated for 1 Oscar. Another 1 win & 13 nominations.,1,1,13,15
1385,Tucker and Dale vs Evil,10 wins & 14 nominations.,0,10,14,24
1386,Rabbit Hole,Nominated for 1 Oscar. Another 7 wins & 41 nominations.,1,7,41,49
1387,Leap Year,,0,0,0,0
1388,In a Better World,,0,0,0,0
1389,The Book of Eli,3 wins & 16 nominations,0,3,16,19
1390,The Ghost Writer,33 wins & 55 nominations.,0,33,55,88
1391,The Other Guys,3 wins & 15 nominations,0,3,15,18
1392,Cyrus,6 nominations,0,0,6,6
1393,Jonah Hex,1 win & 4 nominations.,0,1,4,5
1394,Submarine,Nominated for 1 BAFTA Film Award. Another 6 wins & 16 nominations.,0,6,17,23
1395,Clash of the Titans,4 wins & 14 nominations,0,4,14,18
1396,Animal Kingdom,Nominated for 1 Oscar. Another 39 wins & 59 nominations.,1,39,59,99
1397,Kites: M�s all� de las fronteras,,0,0,0,0
1398,Dear John,4 wins & 8 nominations.,0,4,8,12
1399,The Tempest,Nominated for 1 Oscar. 2 wins & 5 nominations total,1,2,5,8
1400,Iron Man 2,Nominated for 1 Oscar. Another 7 wins & 43 nominations.,1,7,43,51
1401,The Fighter,Won 2 Oscars. Another 71 wins & 124 nominations.,2,71,124,197
1402,Kaboom,1 win & 2 nominations.,0,1,2,3
1403,The Town,Nominated for 1 Oscar. Another 9 wins & 45 nominations.,1,9,45,55
1404,The Bounty Hunter,4 wins & 5 nominations,0,4,5,9
1405,You Again,2 wins.,0,2,0,2
1406,The Wolfman,Won 1 Oscar. 4 wins & 8 nominations total,1,4,8,13
1407,Somewhere,4 wins & 8 nominations.,0,4,8,12
1408,13 Assassins,15 wins & 28 nominations.,0,15,28,43
1409,Yogi Bear,2 wins & 2 nominations.,0,2,2,4
1410,Super,1 win.,0,1,0,1
1411,Centurion,1 nomination,0,0,1,1
1412,Incendies,Nominated for 1 Oscar. Another 39 wins & 16 nominations.,1,39,16,56
1413,The Tourist,4 wins & 4 nominations.,0,4,4,8
1414,La llave de Sarah,,0,0,0,0
1415,The Sorcerer's Apprentice,1 win & 2 nominations.,0,1,2,3
1416,I Spit on Your Grave,2 nominations.,0,0,2,2
1417,I Saw the Devil,,0,0,0,0
1418,She's Out of My League,1 nomination.,0,0,1,1
1419,The A-Team,2 wins & 4 nominations.,0,2,4,6
1420,Step Up 3D,2 nominations,0,0,2,2
1421,Stone,,0,0,0,0
1422,The American,4 nominations.,0,0,4,4
1423,Boy,13 wins & 9 nominations.,0,13,9,22
1424,127 Hours,Nominated for 6 Oscars. Another 23 wins & 144 nominations.,6,23,144,173
1425,It's Kind of a Funny Story,2 nominations,0,0,2,2
1426,Cats & Dogs: The Revenge of Kitty Galore,11 wins & 7 nominations.,0,11,7,18
1427,Hot Tub Time Machine,5 nominations.,0,0,5,5
1428,The Way Back,Nominated for 1 Oscar. Another 4 wins & 4 nominations.,1,4,4,9
1429,The Way,1 win & 8 nominations.,0,1,8,9
1430,The Expendables,3 wins & 5 nominations.,0,3,5,8
1431,Date Night,4 wins & 8 nominations,0,4,8,12
1432,The Social Network,Won 3 Oscars. Another 169 wins & 186 nominations.,3,169,186,358
1433,The Debt,13 wins & 5 nominations.,0,13,5,18
1434,Inception,Won 4 Oscars. Another 153 wins & 220 nominations.,4,153,220,377
1435,The Warrior's Way,1 win,0,1,0,1
1436,Casino Jack,1 win & 2 nominations.,0,1,2,3
1437,The Back-up Plan,2 nominations.,0,0,2,2
1438,TRON: Legacy,Nominated for 1 Oscar. Another 10 wins & 50 nominations.,1,10,50,61
1439,Conviction,9 wins & 9 nominations.,0,9,9,18
1440,The Perfect Host,3 wins,0,3,0,3
1441,Insidious,8 wins & 15 nominations.,0,8,15,23
1442,Stake Land,3 wins & 11 nominations.,0,3,11,14
1443,Knight and Day,3 nominations.,0,0,3,3
1444,How Do You Know,3 nominations.,0,0,3,3
1445,The Switch,1 win & 3 nominations.,0,1,3,4
1446,Ip Man 2,,0,0,0,0
1447,Tamara Drewe,3 wins & 3 nominations.,0,3,3,6
1448,Takers,2 wins & 6 nominations.,0,2,6,8
1449,Tangled,Nominated for 1 Oscar. Another 10 wins & 40 nominations.,1,10,40,51
1450,The Company Men,2 wins & 11 nominations.,0,2,11,13
1451,Devil,2 nominations,0,0,2,2
1452,Dinner for Schmucks,1 nomination,0,0,1,1
1453,The Spy Next Door,2 nominations.,0,0,2,2
1454,Kick-Ass,19 wins & 62 nominations,0,19,62,81
1455,Diary of a Wimpy Kid,5 wins & 9 nominations,0,5,9,14
1456,Shutter Island,11 wins & 66 nominations,0,11,66,77
1457,Another Year,Nominated for 1 Oscar. Another 23 wins & 56 nominations.,1,23,56,80
1458,Killers,2 wins & 3 nominations.,0,2,3,5
1459,Charlie St. Cloud,4 nominations,0,0,4,4
1460,Last Night,4 nominations,0,0,4,4
1461,The Chronicles of Narnia: The Voyage of the Dawn Treader,2 wins & 18 nominations.,0,2,18,20
1462,Shrek Forever After,1 win & 13 nominations,0,1,13,14
1463,How to Train Your Dragon,Nominated for 2 Oscars. Another 25 wins & 61 nominations.,2,25,61,88
1464,You Will Meet a Tall Dark Stranger,2 wins & 6 nominations.,0,2,6,8
1465,The Twilight Saga: Eclipse,22 wins & 34 nominations.,0,22,34,56
1466,Country Strong,Nominated for 1 Oscar. Another 1 win & 7 nominations.,1,1,7,9
1467,The Crazies,11 nominations,0,0,11,11
1468,Burlesque,Won 1 Golden Globe. Another 5 wins & 19 nominations.,0,6,19,25
1469,Skyline,1 nomination.,0,0,1,1
1470,Cop Out,1 nomination,0,0,1,1
1471,Burke and Hare,1 nomination,0,0,1,1
1472,The Housemaid,15 wins & 11 nominations.,0,15,11,26
1473,Beginners,Won 1 Oscar. Another 35 wins & 30 nominations.,1,35,30,66
1474,The Next Three Days,3 nominations,0,0,3,3
1475,The Secret World of Arrietty,12 wins & 6 nominations.,0,12,6,18
1476,Certified Copy,10 wins & 28 nominations.,0,10,28,38
1477,Dirty Girl,,0,0,0,0
1478,I'm Still Here,1 win & 4 nominations.,0,1,4,5
1479,Tooth Fairy,1 win & 4 nominations.,0,1,4,5
1480,La versi�n de mi vida,,0,0,0,0
1481,La vida seg�n Attenberg,,0,0,0,0
1482,The Conspirator,2 wins & 3 nominations,0,2,3,5
1483,The Trip,2 nominations.,0,0,2,2
1484,Tiny Furniture,5 wins & 8 nominations.,0,5,8,13
1485,Despicable Me,Nominated for 1 BAFTA Film Award. Another 3 wins & 40 nominations.,0,3,41,44
1486,Taking Woodstock,8 nominations,0,0,8,8
1487,I Am Love,,0,0,0,0
1488,Obsessed,4 wins & 8 nominations.,0,4,8,12
1489,The Disappearance of Alice Creed,1 win & 6 nominations.,0,1,6,7
1490,Public Enemies,1 win & 14 nominations,0,1,14,15
1491,Observe and Report,1 win & 4 nominations.,0,1,4,5
1492,Crazy Heart,Won 2 Oscars. 39 wins & 33 nominations total,2,39,33,74
1493,G-Force,1 win & 1 nomination.,0,1,1,2
1494,Push,1 win & 2 nominations.,0,1,2,3
1495,Confessions of a Shopaholic,1 win & 3 nominations.,0,1,3,4
1496,Enter the Void,4 wins & 8 nominations.,0,4,8,12
1497,Crank: High Voltage,1 win & 2 nominations.,0,1,2,3
1498,Ondine,6 wins & 6 nominations,0,6,6,12
1499,Old Dogs,5 nominations,0,0,5,5
1500,Case 39,3 nominations.,0,0,3,3
1501,Coraline,Nominated for 1 Oscar. Another 8 wins & 45 nominations.,1,8,45,54
1502,Race to Witch Mountain,1 nomination.,0,0,1,1
1503,The Road,5 wins & 34 nominations total,0,5,34,39
1504,The Time Traveler's Wife,1 win & 5 nominations.,0,1,5,6
1505,Anticristo,,0,0,0,0
1506,Couples Retreat,1 win & 4 nominations,0,1,4,5
1507,Tanner Hall,2 wins.,0,2,0,2
1508,Beyond a Reasonable Doubt,,0,0,0,0
1509,Terminator Salvation,2 wins & 14 nominations.,0,2,14,16
1510,3 Idiots,64 wins & 23 nominations.,0,64,23,87
1511,Funny People,3 nominations.,0,0,3,3
1512,Cracks,3 nominations.,0,0,3,3
1513,Carriers,1 nomination.,0,0,1,1
1514,Madea Goes to Jail,1 win & 4 nominations.,0,1,4,5
1515,A Serious Man,Nominated for 2 Oscars. 17 wins & 80 nominations total,2,17,80,99
1516,Tetro,1 win & 5 nominations.,0,1,5,6
1517,The White Ribbon,Nominated for 2 Oscars. Another 62 wins & 46 nominations.,2,62,46,110
1518,A Prophet,Nominated for 1 Oscar. Another 52 wins & 54 nominations.,1,52,54,107
1519,The Girlfriend Experience,1 nomination,0,0,1,1
1520,After.Life,1 nomination.,0,0,1,1
1521,Fast & Furious,10 wins & 22 nominations.,0,10,22,32
1522,2012,5 wins & 21 nominations.,0,5,21,26
1523,The Soloist,1 win & 3 nominations,0,1,3,4
1524,The Ugly Truth,3 wins & 5 nominations.,0,3,5,8
1525,The Damned United,5 nominations.,0,0,5,5
1526,Perrier's Bounty,3 nominations.,0,0,3,3
1527,Ch�ri,,0,0,0,0
1528,The Haunting in Connecticut,1 win & 2 nominations.,0,1,2,3
1529,Fantastic Mr. Fox,Nominated for 2 Oscars. Another 32 wins & 61 nominations.,2,32,61,95
1530,Cirque du Freak: The Vampire's Assistant,1 win.,0,1,0,1
1531,Underworld: Rise of the Lycans,2 nominations.,0,0,2,2
1532,Pandorum,,0,0,0,0
1533,Fanboys,,0,0,0,0
1534,Fame,Won 2 Oscars. Another 5 wins & 16 nominations.,2,5,16,23
1535,Paper Man,1 win.,0,1,0,1
1536,Chloe,3 wins & 5 nominations.,0,3,5,8
1537,Pirate Radio,1 win.,0,1,0,1
1538,The Collector,,0,0,0,0
1539,G.I. Joe: The Rise of Cobra,3 wins & 16 nominations,0,3,16,19
1540,17 Again,3 wins & 5 nominations,0,3,5,8
1541,Ice Age: Dawn of the Dinosaurs,3 wins & 13 nominations.,0,3,13,16
1542,The Last Station,Nominated for 2 Oscars. 5 wins & 18 nominations total,2,5,18,25
1543,My Life in Ruins,1 nomination.,0,0,1,1
1544,Adventureland,1 win & 4 nominations,0,1,4,5
1545,Fighting,1 nomination.,0,0,1,1
1546,My Bloody Valentine,4 nominations,0,0,4,4
1547,The Twilight Saga: New Moon,20 wins & 24 nominations.,0,20,24,44
1548,Paul Blart: Mall Cop,1 win & 3 nominations.,0,1,3,4
1549,Jennifer's Body,3 wins & 4 nominations.,0,3,4,7
1550,Black Dynamite,1 win & 4 nominations,0,1,4,5
1551,Gamer,1 win.,0,1,0,1
1552,The Canyon,,0,0,0,0
1553,City Island,3 wins & 4 nominations.,0,3,4,7
1554,I Can Do Bad All by Myself,1 win & 5 nominations.,0,1,5,6
1555,Coco Before Chanel,Nominated for 1 Oscar. Another 5 wins & 19 nominations.,1,5,19,25
1556,"I Love You, Beth Cooper",1 win & 1 nomination,0,1,1,2
1557,Youth in Revolt,1 win & 1 nomination.,0,1,1,2
1558,Up in the Air,Nominated for 6 Oscars. Another 75 wins & 164 nominations.,6,75,164,245
1559,Fish Tank,21 wins & 29 nominations total,0,21,29,50
1560,Una pareja dispareja,,0,0,0,0
1561,Zombieland,10 wins & 29 nominations,0,10,29,39
1562,Hannah Montana: The Movie,6 wins & 10 nominations.,0,6,10,16
1563,Cloudy with a Chance of Meatballs,1 win & 14 nominations.,0,1,14,15
1564,Whatever Works,2 wins & 1 nomination,0,2,1,3
1565,Julie & Julia,Nominated for 2 Oscars. 2 nominations total,0,2,2,4
1566,I Hope They Serve Beer in Hell,,0,0,0,0
1567,Orphan,1 win & 7 nominations.,0,1,7,8
1568,It's Complicated,8 wins & 15 nominations total,0,8,15,23
1569,Halloween II,1 win & 3 nominations.,0,1,3,4
1570,"I Love You, Man",1 win & 8 nominations.,0,1,8,9
1571,Arthur and the Revenge of Maltazard,,0,0,0,0
1572,Adam,2 wins & 2 nominations,0,2,2,4
1573,The Box,6 nominations,0,0,6,6
1574,Up,Won 2 Oscars. 79 wins & 87 nominations total,2,79,87,168
1575,Fired Up!,1 nomination,0,0,1,1
1576,The Uninvited,2 nominations.,0,0,2,2
1577,The Boondock Saints II: All Saints Day,,0,0,0,0
1578,Agora,11 wins & 15 nominations,0,11,15,26
1579,The Last House on the Left,1 win & 8 nominations.,0,1,8,9
1580,Precious,Won 2 Oscars. Another 111 wins & 103 nominations.,2,111,103,216
1581,Planeta 51,,0,0,0,0
1582,The Blind Side,Won 1 Oscar. Another 8 wins & 30 nominations.,1,8,30,39
1583,Extract,,0,0,0,0
1584,Armored,,0,0,0,0
1585,Astro Boy,4 nominations.,0,0,4,4
1586,The Girl Who Kicked the Hornet's Nest,1 win & 3 nominations.,0,1,3,4
1587,The Princess and the Frog,Nominated for 3 Oscars. Another 10 wins & 39 nominations.,3,10,39,52
1588,The Good Guy,,0,0,0,0
1589,The House of the Devil,3 wins & 6 nominations,0,3,6,9
1590,Sorority Row,2 nominations.,0,0,2,2
1591,Dead Snow,1 win & 6 nominations.,0,1,6,7
1592,Year One,1 nomination,0,0,1,1
1593,Away We Go,3 wins & 10 nominations.,0,3,10,13
1594,New in Town,,0,0,0,0
1595,The Slammin' Salmon,,0,0,0,0
1596,A Single Man,Nominated for 1 Oscar. Another 39 wins & 57 nominations.,1,39,57,97
1597,Dragonball: Evolution,1 nomination.,0,0,1,1
1598,500 Days of Summer,Nominated for 2 Golden Globes. Another 17 wins & 56 nominations.,0,17,58,75
1599,The Proposal,7 wins & 20 nominations,0,7,20,27
1600,Transformers: Revenge of the Fallen,Nominated for 1 Oscar. Another 15 wins & 30 nominations.,1,15,30,46
1601,Monsters vs. Aliens,3 wins & 10 nominations.,0,3,10,13
1602,Drag Me to Hell,7 wins & 24 nominations.,0,7,24,31
1603,Ghosts of Girlfriends Past,1 win.,0,1,0,1
1604,The Final Destination,2 wins & 2 nominations.,0,2,2,4
1605,In the Loop,Nominated for 1 Oscar. 16 wins & 43 nominations total,1,16,43,60
1606,Splice: experimento mortal,,0,0,0,0
1607,Spread,,0,0,0,0
1608,Watchmen,11 wins & 24 nominations.,0,11,24,35
1609,Night at the Museum: Battle of the Smithsonian,2 wins & 9 nominations.,0,2,9,11
1610,The Secret in Their Eyes,Won 1 Oscar. Another 52 wins & 43 nominations.,1,52,43,96
1611,A Christmas Carol,3 wins & 5 nominations.,0,3,5,8
1612,The Fourth Kind,1 nomination.,0,0,1,1
1613,The Invention of Lying,1 nomination,0,0,1,1
1614,Star Trek,Won 1 Oscar. 27 wins & 95 nominations total,1,27,95,123
1615,Thirst,17 wins & 19 nominations.,0,17,19,36
1616,Bad Lieutenant: Port of Call New Orleans,3 wins & 13 nominations.,0,3,13,16
1617,Nine,Nominated for 4 Oscars. Another 8 wins & 56 nominations.,4,8,56,68
1618,Amelia,3 wins & 4 nominations.,0,3,4,7
1619,Broken Embraces,Nominated for 1 Golden Globe. Another 9 wins & 45 nominations.,0,9,46,55
1620,Bride Wars,1 win & 8 nominations.,0,1,8,9
1621,Get Low,4 wins & 28 nominations.,0,4,28,32
1622,Solitary Man,2 wins & 3 nominations,0,2,3,5
1623,La hermandad,,0,0,0,0
1624,Duplicity,1 win & 4 nominations.,0,1,4,5
1625,Shorts,1 win & 1 nomination.,0,1,1,2
1626,The Informant!,1 win & 20 nominations,0,1,20,21
1627,A Perfect Getaway,1 nomination.,0,0,1,1
1628,Mystery Team,,0,0,0,0
1629,Did You Hear About the Morgans?,2 nominations.,0,0,2,2
1630,Dogtooth,Nominated for 1 Oscar. Another 20 wins & 19 nominations.,1,20,19,40
1631,Miss March,2 nominations.,0,0,2,2
1632,Land of the Lost,2 wins & 9 nominations.,0,2,9,11
1633,The Imaginarium of Doctor Parnassus,Nominated for 2 Oscars. Another 5 wins & 21 nominations.,2,5,21,28
1634,Bright Star,Nominated for 1 Oscar. Another 16 wins & 53 nominations.,1,16,53,70
1635,9,9 nominations.,0,0,9,9
1636,Inglourious Basterds,Won 1 Oscar. Another 132 wins & 172 nominations.,1,132,172,305
1637,Sherlock Holmes,Nominated for 2 Oscars. 10 wins & 31 nominations total,2,10,31,43
1638,District 13: Ultimatum,,0,0,0,0
1639,Law Abiding Citizen,3 wins & 5 nominations.,0,3,5,8
1640,The Lovely Bones,Nominated for 1 Oscar. Another 10 wins & 45 nominations.,1,10,45,56
1641,Moon,Won 1 BAFTA Film Award. Another 27 wins & 37 nominations.,0,28,37,65
1642,Sin Nombre,14 wins & 18 nominations.,0,14,18,32
1643,Today's Special,,0,0,0,0
1644,Sector 9,1 win.,0,1,0,1
1645,Donde viven los monstruos,,0,0,0,0
1646,World's Greatest Dad,1 nomination,0,0,1,1
1647,12 Rounds,,0,0,0,0
1648,X-Men Origins: Wolverine,3 wins & 21 nominations.,0,3,21,24
1649,The International,1 win & 1 nomination.,0,1,1,2
1650,An Education,Nominated for 3 Oscars. 36 wins & 96 nominations total,3,36,96,135
1651,[Rec] 2,,0,0,0,0
1652,A �l no le gustas tanto,,0,0,0,0
1653,Friday the 13th,5 nominations.,0,0,5,5
1654,Defendor,1 win & 7 nominations.,0,1,7,8
1655,Ninja Assassin,,0,0,0,0
1656,About Elly,,0,0,0,0
1657,Street Fighter: La leyenda,,0,0,0,0
1658,Surrogates,,0,0,0,0
1659,Valhalla Rising,4 wins & 9 nominations,0,4,9,13
1660,Brooklyn's Finest,1 win & 10 nominations.,0,1,10,11
1661,The Taking of Pelham 123,1 win & 7 nominations.,0,1,7,8
1662,"The Goods: Live Hard, Sell Hard",,0,0,0,0
1663,Invictus,Nominated for 2 Oscars. 12 wins & 37 nominations total,2,12,37,51
1664,Whiteout,,0,0,0,0
1665,The Hangover,Won 1 Golden Globe. Another 12 wins & 25 nominations.,0,13,25,38
1666,The Men Who Stare at Goats,1 win & 1 nomination,0,1,1,2
1667,Summer Wars,10 wins & 5 nominations.,0,10,5,15
1668,Love Happens,1 win.,0,1,0,1
1669,Crossing Over,1 win.,0,1,0,1
1670,Love and Other Impossible Pursuits,,0,0,0,0
1671,Middle Men,,0,0,0,0
1672,El juego del miedo VI,,0,0,0,0
1673,Notorious,Nominated for 2 Oscars. Another 3 wins & 1 nomination.,2,3,1,6
1674,Mr. Nobody,11 wins & 6 nominations.,0,11,6,17
1675,Survival of the Dead,2 nominations,0,0,2,2
1676,Now & Later,1 win & 3 nominations,0,1,3,4
1677,The Joneses,1 nomination,0,0,1,1
1678,All About Steve,2 wins & 3 nominations.,0,2,3,5
1679,Bitch Slap,,0,0,0,0
1680,Whip It,8 nominations.,0,0,8,8
1681,Brothers,Nominated for 2 Golden Globes. Another 4 wins & 14 nominations.,0,4,16,20
1682,Aliens in the Attic,2 nominations,0,0,2,2
1683,Nowhere Boy,Nominated for 3 BAFTA Film Awards. Another 6 wins & 18 nominations.,0,6,21,27
1684,Harry Potter and the Half-Blood Prince,Nominated for 1 Oscar. Another 9 wins & 38 nominations.,1,9,38,48
1685,The Pink Panther 2,3 nominations,0,0,3,3
1686,Br�no,,0,0,0,0
1687,Harry Brown,1 win & 4 nominations,0,1,4,5
1688,The Human Centipede (First Sequence),8 wins & 3 nominations.,0,8,3,11
1689,The Young Victoria,Won 1 Oscar. 13 wins & 17 nominations total,1,13,17,31
1690,The Girl Who Played with Fire,1 win & 4 nominations.,0,1,4,5
1691,The Secret of Kells,Nominated for 1 Oscar. Another 7 wins & 6 nominations.,1,7,6,14
1692,My Sister's Keeper,4 wins & 4 nominations.,0,4,4,8
1693,Alvin and the Chipmunks: The Squeakquel,3 wins.,0,3,0,3
1694,Knowing,1 win & 6 nominations,0,1,6,7
1695,Avatar,Won 3 Oscars. Another 86 wins & 130 nominations.,3,86,130,219
1696,State of Play,2 wins & 4 nominations,0,2,4,6
1697,The Messenger,Nominated for 2 Oscars. Another 17 wins & 44 nominations.,2,17,44,63
1698,Hotel para perros,,0,0,0,0
1699,Angels & Demons,1 win & 5 nominations,0,1,5,6
1700,The Limits of Control,1 win,0,1,0,1
1701,Meet the Browns,3 nominations.,0,0,3,3
1702,Igor,1 nomination.,0,0,1,1
1703,Miracle at St. Anna,1 win & 10 nominations.,0,1,10,11
1704,Nim's Island,2 wins & 3 nominations.,0,2,3,5
1705,First Sunday,,0,0,0,0
1706,Nights in Rodanthe,1 nomination,0,0,1,1
1707,Ceguera,,0,0,0,0
1708,The Spirit,4 nominations,0,0,4,4
1709,Oorlogswinter,10 wins & 9 nominations,0,10,9,19
1710,Valkyrie,3 wins & 11 nominations.,0,3,11,14
1711,Iron Man,Nominated for 2 Oscars. Another 21 wins & 71 nominations.,2,21,71,94
1712,The Forbidden Kingdom,5 nominations.,0,0,5,5
1713,The Curious Case of Benjamin Button,Won 3 Oscars. Another 80 wins & 160 nominations.,3,80,160,243
1714,The Day the Earth Stood Still,2 wins & 5 nominations,0,2,5,7
1715,"War, Inc.",1 nomination.,0,0,1,1
1716,Changeling,Nominated for 3 Oscars. Another 14 wins & 51 nominations.,3,14,51,68
1717,The Express,1 win & 3 nominations.,0,1,3,4
1718,Vantage Point,2 wins & 2 nominations.,0,2,2,4
1719,Chaos Theory,1 nomination,0,0,1,1
1720,The Happening,3 wins & 10 nominations.,0,3,10,13
1721,Frost/Nixon,Nominated for 5 Oscars. 23 wins & 80 nominations total,5,23,80,108
1722,Gomorrah,Nominated for 1 BAFTA Film Award. Another 34 wins & 40 nominations.,0,34,41,75
1723,The Strangers,1 win & 15 nominations.,0,1,15,16
1724,Me and Orson Welles,Nominated for 1 BAFTA Film Award. Another 5 wins & 26 nominations.,0,5,27,32
1725,"10,000 BC",,0,0,0,0
1726,The Sisterhood of the Traveling Pants 2,1 nomination,0,0,1,1
1727,The Spiderwick Chronicles,2 wins & 8 nominations.,0,2,8,10
1728,Burn After Reading,8 wins & 32 nominations total,0,8,32,40
1729,Nothing But the Truth,2 wins & 2 nominations.,0,2,2,4
1730,Fool's Gold,5 nominations,0,0,5,5
1731,Meet the Spartans,6 nominations.,0,0,6,6
1732,The Rocker,,0,0,0,0
1733,Nick and Norah's Infinite Playlist,9 nominations,0,0,9,9
1734,Fireproof,1 win.,0,1,0,1
1735,Australia,Nominated for 1 Oscar. Another 12 wins & 35 nominations.,1,12,35,48
1736,The Family That Preys,3 wins & 7 nominations.,0,3,7,10
1737,Mesrine Part 1: Killer Instinct,,0,0,0,0
1738,One Missed Call,2 nominations.,0,0,2,2
1739,"New York, I Love You",1 nomination,0,0,1,1
1740,Milk,Won 2 Oscars. Another 64 wins & 144 nominations.,2,64,144,210
1741,Fireflies in the Garden,1 nomination.,0,0,1,1
1742,Never Back Down,1 win,0,1,0,1
1743,Meet Dave,2 wins & 3 nominations.,0,2,3,5
1744,The Escapist,2 wins & 6 nominations.,0,2,6,8
1745,The Tale of Despereaux,1 win & 8 nominations,0,1,8,9
1746,Gran Torino,21 wins & 22 nominations.,0,21,22,43
1747,The Edge of Love,1 win & 2 nominations.,0,1,2,3
1748,The Duchess,Won 1 Oscar. Another 7 wins & 21 nominations.,1,7,21,29
1749,Good Dick,1 win & 1 nomination.,0,1,1,2
1750,Forgetting Sarah Marshall,4 wins & 19 nominations,0,4,19,23
1751,Miss Pettigrew Lives for a Day,1 nomination.,0,0,1,1
1752,The Dark Knight,Won 2 Oscars. Another 157 wins & 163 nominations.,2,157,163,322
1753,Untraceable,1 win,0,1,0,1
1754,The Stoning of Soraya M.,8 wins & 8 nominations.,0,8,8,16
1755,Forever Strong,1 win.,0,1,0,1
1756,Mirrors,2 nominations.,0,0,2,2
1757,Over Her Dead Body,,0,0,0,0
1758,The Red Baron,2 nominations.,0,0,2,2
1759,B�squeda implacable,,0,0,0,0
1760,Cadillac Records,6 wins & 21 nominations,0,6,21,27
1761,In Bruges,Nominated for 1 Oscar. Another 24 wins & 54 nominations.,1,24,54,79
1762,Ni en tu casa ni en la m�a,,0,0,0,0
1763,Flame & Citron,5 wins & 1 nomination.,0,5,1,6
1764,The Incredible Hulk,1 win & 10 nominations.,0,1,10,11
1765,"Welcome Home, Roscoe Jenkins",,0,0,0,0
1766,Eagle Eye,3 wins & 8 nominations,0,3,8,11
1767,Stop-Loss,2 wins & 5 nominations,0,2,5,7
1768,Waltz with Bashir,Nominated for 1 Oscar. Another 45 wins & 62 nominations.,1,45,62,108
1769,Easy Virtue,2 wins & 6 nominations.,0,2,6,8
1770,Step Up 2: The Streets,2 wins & 3 nominations.,0,2,3,5
1771,Step Brothers,3 wins & 2 nominations.,0,3,2,5
1772,Wild Child,,0,0,0,0
1773,WALL�E,Won 1 Oscar. Another 92 wins & 95 nominations.,1,92,95,188
1774,Yes Man,3 wins & 9 nominations,0,3,9,12
1775,Brideshead Revisited,11 nominations,0,0,11,11
1776,Babylon A.D.,1 nomination.,0,0,1,1
1777,RocknRolla,1 win & 5 nominations.,0,1,5,6
1778,Hell Ride,1 win.,0,1,0,1
1779,Bronson,3 wins & 7 nominations.,0,3,7,10
1780,Indiana Jones and the Kingdom of the Crystal Skull,Nominated for 1 BAFTA Film Award. Another 10 wins & 41 nominations.,0,10,42,52
1781,Hellboy II: The Golden Army,Nominated for 1 Oscar. Another 5 wins & 34 nominations.,1,5,34,40
1782,The Reader,Won 1 Oscar. 26 wins & 48 nominations total,1,26,48,75
1783,Righteous Kill,1 win & 2 nominations.,0,1,2,3
1784,Eden Lake,9 wins & 8 nominations.,0,9,8,17
1785,Strange Wilderness,,0,0,0,0
1786,Tropic Thunder,Nominated for 1 Oscar. Another 10 wins & 46 nominations.,1,10,46,57
1787,"Surfer, Dude",,0,0,0,0
1788,Superhero Movie,1 win.,0,1,0,1
1789,Sunshine Cleaning,2 wins & 6 nominations.,0,2,6,8
1790,Killshot,,0,0,0,0
1791,You Don't Mess with the Zohan,2 wins & 2 nominations,0,2,2,4
1792,Repo! The Genetic Opera,3 wins & 1 nomination.,0,3,1,4
1793,W.,1 win & 8 nominations.,0,1,8,9
1794,Beverly Hills Chihuahua,3 wins & 6 nominations.,0,3,6,9
1795,Kit Kittredge: An American Girl,2 wins & 5 nominations,0,2,5,7
1796,Street Kings,1 nomination.,0,0,1,1
1797,The Merry Gentleman,3 wins & 1 nomination.,0,3,1,4
1798,The Wrestler,Nominated for 2 Oscars. 58 wins & 93 nominations total,2,58,93,153
1799,Revolutionary Road,Nominated for 3 Oscars. Another 20 wins & 70 nominations.,3,20,70,93
1800,The Good the Bad the Weird,12 wins & 27 nominations.,0,12,27,39
1801,The X Files: I Want to Believe,,0,0,0,0
1802,Get Smart,3 wins & 6 nominations.,0,3,6,9
1803,Transsiberian,2 wins & 11 nominations.,0,2,11,13
1804,The Oxford Murders,6 wins & 5 nominations,0,6,5,11
1805,Shutter,1 win & 1 nomination.,0,1,1,2
1806,Doubt,Nominated for 5 Oscars. 25 wins & 96 nominations total,5,25,96,126
1807,Doomsday,1 nomination,0,0,1,1
1808,Donkey Punch,5 nominations,0,0,5,5
1809,Traitor,5 nominations.,0,0,5,5
1810,Ghost Town,3 wins & 2 nominations,0,3,2,5
1811,The Informers,,0,0,0,0
1812,Semi-Pro,1 win & 4 nominations.,0,1,4,5
1813,Lakeview Terrace,1 nomination,0,0,1,1
1814,Bolt,Nominated for 1 Oscar. Another 1 win & 31 nominations.,1,1,31,33
1815,The Mummy: Tomb of the Dragon Emperor,2 wins & 6 nominations.,0,2,6,8
1816,Seven Pounds,4 wins & 7 nominations.,0,4,7,11
1817,Sex Drive,,0,0,0,0
1818,Leatherheads,1 win & 3 nominations.,0,1,3,4
1819,Sex and the City,2 wins & 12 nominations,0,2,12,14
1820,High School Musical 3: Senior Year,8 wins & 9 nominations.,0,8,9,17
1821,Disaster Movie,1 win & 6 nominations.,0,1,6,7
1822,Let the Right One In,Nominated for 1 BAFTA Film Award. Another 75 wins & 57 nominations.,0,75,58,133
1823,Saw V,1 win & 2 nominations,0,1,2,3
1824,"Definitely, Maybe",1 win & 1 nomination.,0,1,1,2
1825,Defiance,Nominated for 1 Oscar. 2 wins & 5 nominations total,1,2,5,8
1826,Kung Fu Panda,Nominated for 1 Oscar. Another 14 wins & 38 nominations.,1,14,38,53
1827,The Midnight Meat Train,2 wins & 6 nominations.,0,2,6,8
1828,The Hurt Locker,Won 6 Oscars. 125 wins & 130 nominations total,6,125,130,261
1829,The Secret Life of Bees,11 wins & 17 nominations.,0,11,17,28
1830,Drillbit Taylor,1 win & 2 nominations.,0,1,2,3
1831,Horton Hears a Who!,1 win & 18 nominations.,0,1,18,19
1832,The Love Guru,5 wins & 8 nominations,0,5,8,13
1833,Speed Racer,1 win & 12 nominations.,0,1,12,13
1834,Body of Lies,2 nominations.,0,0,2,2
1835,Ghajini,12 wins & 18 nominations.,0,12,18,30
1836,Soul Men,3 nominations.,0,0,3,3
1837,Dream Boy,2 wins,0,2,0,2
1838,Death Race,1 win & 5 nominations.,0,1,5,6
1839,Deception,1 nomination,0,0,1,1
1840,Slumdog Millionaire,Won 8 Oscars. Another 145 wins & 133 nominations.,8,145,133,286
1841,El libro m�gico,,0,0,0,0
1842,Surveillance,3 wins & 5 nominations.,0,3,5,8
1843,Swing Vote,1 nomination.,0,0,1,1
1844,Pontypool,1 win & 11 nominations,0,1,11,12
1845,City of Ember,6 nominations.,0,0,6,6
1846,21,1 win & 5 nominations,0,1,5,6
1847,What Just Happened,1 nomination.,0,0,1,1
1848,Mutant Chronicles,,0,0,0,0
1849,Baby Mama,1 win & 5 nominations.,0,1,5,6
1850,Bangkok Dangerous,1 nomination.,0,0,1,1
1851,Journey to the Center of the Earth,3 wins & 4 nominations.,0,3,4,7
1852,Ponyo,12 wins & 20 nominations.,0,12,20,32
1853,The Baader Meinhof Complex,Nominated for 1 Oscar. Another 4 wins & 20 nominations.,1,4,20,25
1854,The Bank Job,3 nominations.,0,0,3,3
1855,Garden Party,,0,0,0,0
1856,The Wackness,4 wins & 4 nominations,0,4,4,8
1857,Cloverfield,5 wins & 34 nominations.,0,5,34,39
1858,Hamlet 2,3 nominations.,0,0,3,3
1859,Hancock,4 wins & 14 nominations.,0,4,14,18
1860,Pretty Ugly People,2 wins.,0,2,0,2
1861,The Boy in the Striped Pajamas,,0,0,0,0
1862,Pineapple Express,2 wins & 15 nominations.,0,2,15,17
1863,The Ruins,7 nominations,0,0,7,7
1864,My Best Friend's Girl,1 nomination.,0,0,1,1
1865,Felon,,0,0,0,0
1866,The Haunting of Molly Hartley,1 nomination.,0,0,1,1
1867,Welcome to the Sticks,5 wins & 9 nominations.,0,5,9,14
1868,Che: Part One,4 wins & 12 nominations.,0,4,12,16
1869,What Happens in Vegas,5 nominations,0,0,5,5
1870,Pathology,,0,0,0,0
1871,The Class,7 wins & 2 nominations.,0,7,2,9
1872,Max Payne,1 nomination,0,0,1,1
1873,The Chronicles of Narnia: Prince Caspian,2 wins & 21 nominations,0,2,21,23
1874,The Burning Plain,2 wins & 3 nominations,0,2,3,5
1875,Choke,2 wins & 7 nominations,0,2,7,9
1876,Zack and Miri Make a Porno,2 wins & 4 nominations,0,2,4,6
1877,The Brothers Bloom,3 nominations.,0,0,3,3
1878,Marley & Me,Nominated for 1 BAFTA Film Award. Another 1 win & 7 nominations.,0,1,8,9
1879,Mamma Mia!,15 wins & 25 nominations.,0,15,25,40
1880,Pride and Glory,2 nominations,0,0,2,2
1881,Madagascar: Escape 2 Africa,4 wins & 11 nominations,0,4,11,15
1882,Wanted,Nominated for 2 Oscars. 4 wins & 25 nominations total,2,4,25,31
1883,Un par nada ejemplar,,0,0,0,0
1884,The House Bunny,2 nominations.,0,0,2,2
1885,Rambo 4: Regreso al Infierno,,0,0,0,0
1886,Mad Money,2 nominations.,0,0,2,2
1887,Bedtime Stories,3 wins & 5 nominations,0,3,5,8
1888,Red Cliff,14 wins & 44 nominations.,0,14,44,58
1889,Harold & Kumar Escape from Guantanamo Bay,,0,0,0,0
1890,The Women,4 wins & 4 nominations.,0,4,4,8
1891,How to Lose Friends & Alienate People,,0,0,0,0
1892,Elegy,3 wins & 5 nominations,0,3,5,8
1893,Redbelt,1 nomination.,0,0,1,1
1894,"Synecdoche, New York",8 wins & 29 nominations,0,8,29,37
1895,El transportador 3,,0,0,0,0
1896,Two Lovers,3 wins & 18 nominations.,0,3,18,21
1897,Rachel Getting Married,Nominated for 1 Oscar. Another 32 wins & 64 nominations.,1,32,64,97
1898,Prom Night,1 win & 4 nominations.,0,1,4,5
1899,The Hottie & the Nottie,4 wins & 4 nominations.,0,4,4,8
1900,I Can't Think Straight,3 wins & 1 nomination.,0,3,1,4
1901,Jumper,2 wins & 5 nominations,0,2,5,7
1902,Be Kind Rewind,4 nominations.,0,0,4,4
1903,The Other Boleyn Girl,3 nominations,0,0,3,3
1904,Vicky Cristina Barcelona,Won 1 Oscar. 32 wins & 54 nominations total,1,32,54,87
1905,College,,0,0,0,0
1906,College Road Trip,1 nomination.,0,0,1,1
1907,Appaloosa,4 wins.,0,4,0,4
1908,Punisher: War Zone,1 win & 1 nomination,0,1,1,2
1909,Bottle Shock,1 nomination,0,0,1,1
1910,27 Dresses,5 wins & 3 nominations.,0,5,3,8
1911,Quantum of Solace,Nominated for 2 BAFTA Film Awards. Another 4 wins & 30 nominations.,0,4,32,36
1912,Quarantine,6 nominations.,0,0,6,6
1913,Happy-Go-Lucky,Nominated for 1 Oscar. Another 39 wins & 62 nominations.,1,39,62,102
1914,Made of Honor,1 win & 1 nomination.,0,1,1,2
1915,Hunger,49 wins & 38 nominations total,0,49,38,87
1916,War,1 nomination,0,0,1,1
1917,Mongol: The Rise of Genghis Khan,Nominated for 1 Oscar. Another 15 wins & 11 nominations.,1,15,11,27
1918,Halloween,8 wins & 2 nominations.,0,8,2,10
1919,In the Valley of Elah,Nominated for 1 Oscar. Another 3 wins & 20 nominations.,1,3,20,24
1920,In the Name of the King: A Dungeon Siege Tale,4 wins & 5 nominations.,0,4,5,9
1921,Lucky You,2 nominations.,0,0,2,2
1922,Love in the Time of Cholera,Nominated for 1 Golden Globe. Another 3 nominations.,0,0,4,4
1923,30 Days of Night,14 nominations.,0,0,14,14
1924,Why Did I Get Married?,,0,0,0,0
1925,The Number 23,5 nominations.,0,0,5,5
1926,Knocked Up,8 wins & 26 nominations.,0,8,26,34
1927,Hounddog,2 wins & 1 nomination.,0,2,1,3
1928,The Messengers,1 win & 2 nominations,0,1,2,3
1929,Live Free or Die Hard,3 wins & 16 nominations,0,3,16,19
1930,Hot Rod,2 nominations,0,0,2,2
1931,3:10 to Yuma,Nominated for 2 Oscars. Another 3 wins & 30 nominations.,2,3,30,35
1932,Wild Hogs,1 win & 4 nominations.,0,1,4,5
1933,Lions for Lambs,3 nominations.,0,0,3,3
1934,"4 Months, 3 Weeks and 2 Days",,0,0,0,0
1935,Hot Fuzz,2 wins & 9 nominations.,0,2,9,11
1936,Hostel: Part II,10 nominations.,0,0,10,10
1937,Wind Chill,,0,0,0,0
1938,Like Stars on Earth,,0,0,0,0
1939,The Mist,6 wins & 13 nominations,0,6,13,19
1940,License to Wed,1 nomination.,0,0,1,1
1941,The Nines,2 nominations.,0,0,2,2
1942,La Vie en Rose,,0,0,0,0
1943,XXY,26 wins & 14 nominations.,0,26,14,40
1944,Beowulf,3 wins & 19 nominations,0,3,19,22
1945,The Nanny Diaries,1 win & 2 nominations.,0,1,2,3
1946,88 Minutes,3 nominations.,0,0,3,3
1947,Hitman - Agente 47,,0,0,0,0
1948,Lars and the Real Girl,Nominated for 1 Oscar. Another 7 wins & 35 nominations.,1,7,35,43
1949,The Reaping,1 nomination,0,0,1,1
1950,Harry Potter and the Order of the Phoenix,Nominated for 2 BAFTA Film Awards. Another 16 wins & 45 nominations.,0,16,47,63
1951,"Lust, Caution",Nominated for 1 Golden Globe. Another 29 wins & 54 nominations.,0,29,55,84
1952,The Orphanage,32 wins & 43 nominations.,0,32,43,75
1953,Zodiac,4 wins & 72 nominations.,0,4,72,76
1954,Bee Movie,1 win & 15 nominations,0,1,15,16
1955,Into the Wild,Nominated for 2 Oscars. 23 wins & 106 nominations total,2,23,106,131
1956,In the Land of Women,,0,0,0,0
1957,Gone Baby Gone,Nominated for 1 Oscar. Another 33 wins & 31 nominations.,1,33,31,65
1958,Good Luck Chuck,1 win & 3 nominations.,0,1,3,4
1959,Michael Clayton,Won 1 Oscar. Another 27 wins & 114 nominations.,1,27,114,142
1960,A Mighty Heart,4 wins & 18 nominations,0,4,18,22
1961,We Own the Night,2 wins & 6 nominations.,0,2,6,8
1962,Mi mascota es un monstruo,,0,0,0,0
1963,Mi historia sin mi,,0,0,0,0
1964,Because I Said So,1 nomination.,0,0,1,1
1965,1408,4 wins & 12 nominations,0,4,12,16
1966,Meet the Robinsons,1 win & 10 nominations,0,1,10,11
1967,2 Days in Paris,2 wins & 5 nominations,0,2,5,7
1968,28 Weeks Later,3 wins & 16 nominations.,0,3,16,19
1969,Grindhouse,10 wins & 22 nominations,0,10,22,32
1970,Before the Devil Knows You're Dead,17 wins & 27 nominations,0,17,27,44
1971,Battle in Seattle,1 win & 4 nominations.,0,1,4,5
1972,Martian Child,2 nominations,0,0,2,2
1973,Margot at the Wedding,3 wins & 13 nominations.,0,3,13,16
1974,I Think I Love My Wife,1 nomination,0,0,1,1
1975,I Now Pronounce You Chuck & Larry,14 nominations.,0,0,14,14
1976,I Know Who Killed Me,8 wins & 4 nominations,0,8,4,12
1977,Hannibal Rising,2 nominations,0,0,2,2
1978,Juno,Won 1 Oscar. Another 88 wins & 99 nominations.,1,88,99,188
1979,Youth Without Youth,1 win & 1 nomination,0,1,1,2
1980,I Am Legend,9 wins & 23 nominations,0,9,23,32
1981,Bridge to Terabithia,6 wins & 5 nominations.,0,6,5,11
1982,The Kite Runner,Nominated for 1 Oscar. Another 6 wins & 24 nominations.,1,6,24,31
1983,Becoming Jane,3 wins & 6 nominations,0,3,6,9
1984,Pathfinder,1 nomination.,0,0,1,1
1985,Sydney White,,0,0,0,0
1986,Sweeney Todd: The Demon Barber of Fleet Street,Won 1 Oscar. Another 33 wins & 77 nominations.,1,33,77,111
1987,Surf's Up,Nominated for 1 Oscar. Another 2 wins & 17 nominations.,1,2,17,20
1988,Superbad,11 wins & 24 nominations,0,11,24,35
1989,Un verano para toda la vida,,0,0,0,0
1990,Epic Movie,2 wins & 3 nominations.,0,2,3,5
1991,The Kingdom,5 nominations.,0,0,5,5
1992,Sukiyaki Western Django,4 wins & 5 nominations,0,4,5,9
1993,Enchanted,Nominated for 3 Oscars. 12 wins & 51 nominations total,3,12,51,66
1994,Ratatouille,Won 1 Oscar. Another 66 wins & 42 nominations.,1,66,42,109
1995,Daddy's Little Girls,1 nomination.,0,0,1,1
1996,Dan in Real Life,4 nominations,0,0,4,4
1997,Elizabeth: The Golden Age,Won 1 Oscar. Another 6 wins & 33 nominations.,1,6,33,40
1998,Blood and Chocolate,,0,0,0,0
1999,Redline,1 win & 3 nominations.,0,1,3,4
2000,The Seeker: The Dark Is Rising,,0,0,0,0
2001,Stomp the Yard,9 nominations.,0,0,9,9
2002,Then She Found Me,3 wins & 1 nomination.,0,3,1,4
2003,Balls of Fury,,0,0,0,0
2004,Reign Over Me,3 nominations.,0,0,3,3
2005,Escritores de la libertad,,0,0,0,0
2006,Evan Almighty,2 wins & 11 nominations.,0,2,11,13
2007,TMNT: Las Tortugas Ninja,,0,0,0,0
2008,The Air I Breathe,,0,0,0,0
2009,The Visitor,Nominated for 1 Oscar. Another 19 wins & 34 nominations.,1,19,34,54
2010,Are We Done Yet?,3 nominations.,0,0,3,3
2011,The Simpsons Movie,Nominated for 1 Golden Globe. Another 5 wins & 33 nominations.,0,5,34,39
2012,The Babysitters,,0,0,0,0
2013,Perfect Stranger,1 nomination,0,0,1,1
2014,Pers�polis,,0,0,0,0
2015,The Assassination of Jesse James by the Coward Robert Ford,Nominated for 2 Oscars. Another 26 wins & 68 nominations.,2,26,68,96
2016,Boy A,13 wins & 11 nominations.,0,13,11,24
2017,Fantastic 4: Rise of the Silver Surfer,3 wins & 17 nominations.,0,3,17,20
2018,Pirates of the Caribbean: At World's End,Nominated for 2 Oscars. 22 wins & 51 nominations total,2,22,51,75
2019,Crimen sin perd�n,,0,0,0,0
2020,Underdog,3 nominations,0,0,3,3
2021,Under the Same Moon,8 wins & 2 nominations.,0,8,2,10
2022,Control,Nominated for 1 BAFTA Film Award. Another 31 wins & 34 nominations.,0,31,35,66
2023,Blades of Glory,3 wins & 10 nominations,0,3,10,13
2024,Postal,1 win & 3 nominations.,0,1,3,4
2025,Teeth,2 wins & 10 nominations.,0,2,10,12
2026,Premonition,2 nominations.,0,0,2,2
2027,Talk to Me,8 wins & 14 nominations.,0,8,14,22
2028,Evening,3 nominations.,0,0,3,3
2029,Aliens vs. Predator: Requiem,5 nominations.,0,0,5,5
2030,There Will Be Blood,Won 2 Oscars. Another 114 wins & 137 nominations.,2,114,137,253
2031,Things We Lost in the Fire,3 wins & 2 nominations.,0,3,2,5
2032,American Gangster,Nominated for 2 Oscars. Another 12 wins & 36 nominations.,2,12,36,50
2033,Timber Falls,,0,0,0,0
2034,Rogue,1 win & 4 nominations.,0,1,4,5
2035,Descent,,0,0,0,0
2036,The Invisible,1 nomination.,0,0,1,1
2037,"Run, Fatboy, Run",3 nominations.,0,0,3,3
2038,The Invasion,1 win & 2 nominations,0,1,2,3
2039,Rush Hour 3,9 nominations,0,0,9,9
2040,Diary of the Dead,1 win & 1 nomination.,0,1,1,2
2041,Shrek the Third,Nominated for 1 BAFTA Film Award. Another 5 wins & 16 nominations.,0,5,17,22
2042,Shooter,2 nominations.,0,0,2,2
2043,Sleuth,Nominated for 4 Oscars. Another 5 wins & 7 nominations.,4,5,7,16
2044,Dragon Wars: D-War,,0,0,0,0
2045,Savage Grace,1 win & 2 nominations.,0,1,2,3
2046,Transformers,Nominated for 3 Oscars. 25 wins & 50 nominations total,3,25,50,78
2047,Shoot 'Em Up,3 nominations.,0,0,3,3
2048,Saw IV,2 wins & 7 nominations,0,2,7,9
2049,Shelter,11 wins.,0,11,0,11
2050,Sex and Death 101,1 win.,0,1,0,1
2051,Disturbia,5 wins & 7 nominations,0,5,7,12
2052,Towelhead,1 win & 3 nominations.,0,1,3,4
2053,Rocket Science,2 wins & 7 nominations,0,2,7,9
2054,Smiley Face,1 nomination.,0,0,1,1
2055,The Savages,Nominated for 2 Oscars. 17 wins & 33 nominations total,2,17,33,52
2056,El asesino de John Lennon,,0,0,0,0
2057,Rendition,3 nominations,0,0,3,3
2058,Reno 911!: Miami,,0,0,0,0
2059,Stardust,5 wins & 11 nominations.,0,5,11,16
2060,The Hunting Party,,0,0,0,0
2061,The Jane Austen Book Club,2 nominations.,0,0,2,2
2062,This Christmas,4 nominations.,0,0,4,4
2063,Dead Silence,,0,0,0,0
2064,Spider-Man 3,Nominated for 1 BAFTA Film Award. Another 4 wins & 43 nominations.,0,4,44,48
2065,Death Sentence,3 nominations.,0,0,3,3
2066,Reservation Road,1 win & 2 nominations.,0,1,2,3
2067,Eagle vs Shark,6 wins & 4 nominations,0,6,4,10
2068,Son of Rambow,3 wins & 10 nominations.,0,3,10,13
2069,Resident Evil: Extinction,2 wins & 2 nominations.,0,2,2,4
2070,Retrato de amor,,0,0,0,0
2071,Snow Angels,1 win & 4 nominations.,0,1,4,5
2072,Rewind,2 wins & 4 nominations,0,2,4,6
2073,Alucinaciones,,0,0,0,0
2074,Alvin and the Chipmunks,3 wins & 2 nominations.,0,3,2,5
2075,Eastern Promises,Nominated for 1 Oscar. Another 28 wins & 73 nominations.,1,28,73,102
2076,The Last Legion,2 nominations.,0,0,2,2
2077,Walk Hard: The Dewey Cox Story,1 win & 6 nominations.,0,1,6,7
2078,No Reservations,1 nomination.,0,0,1,1
2079,Awake,1 win & 3 nominations.,0,1,3,4
2080,The Condemned,1 nomination.,0,0,1,1
2081,Music and Lyrics,6 nominations,0,0,6,6
2082,The Game Plan,3 nominations.,0,0,3,3
2083,Across the Universe,Nominated for 1 Oscar. 2 wins & 18 nominations total,1,2,18,21
2084,The Counterfeiters,,0,0,0,0
2085,Charlie Wilson's War,Nominated for 1 Oscar. Another 5 wins & 22 nominations.,1,5,22,28
2086,The Lookout,1 win & 11 nominations,0,1,11,12
2087,Once,Won 1 Oscar. Another 23 wins & 32 nominations.,1,23,32,56
2088,Bratz,5 nominations.,0,0,5,5
2089,Charlie Bartlett,1 win,0,1,0,1
2090,The Darjeeling Limited,4 wins & 4 nominations,0,4,4,8
2091,Funny Games,1 win & 6 nominations.,0,1,6,7
2092,Ocean's Thirteen,1 win & 5 nominations.,0,1,5,6
2093,Breach,1 win & 3 nominations,0,1,3,4
2094,The Comebacks,1 nomination.,0,0,1,1
2095,Nancy Drew,7 nominations.,0,0,7,7
2096,Norbit,Nominated for 1 Oscar. Another 8 wins & 8 nominations.,1,8,8,17
2097,Cassandra's Dream,,0,0,0,0
2098,Vacancy,1 win & 2 nominations,0,1,2,3
2099,Noches p�rpuras,,0,0,0,0
2100,Feast of Love,,0,0,0,0
2101,Fracture,1 win & 2 nominations.,0,1,2,3
2102,National Treasure: Book of Secrets,1 win & 5 nominations.,0,1,5,6
2103,No Country for Old Men,Won 4 Oscars. Another 159 wins & 140 nominations.,4,159,140,303
2104,August Rush,Nominated for 1 Oscar. Another 4 wins & 10 nominations.,1,4,10,15
2105,Fred Claus,,0,0,0,0
2106,The Diving Bell and the Butterfly,,0,0,0,0
2107,Atonement,Won 1 Oscar. Another 50 wins & 149 nominations.,1,50,149,200
2108,Next,2 wins & 3 nominations.,0,2,3,5
2109,The Golden Compass,Won 1 Oscar. Another 6 wins & 32 nominations.,1,6,32,39
2110,The Heartbreak Kid,1 win.,0,1,0,1
2111,Captivity,1 win & 4 nominations.,0,1,4,5
2112,The Hills Have Eyes II,,0,0,0,0
2113,Georgia Rule,3 wins & 5 nominations,0,3,5,8
2114,Paranormal Activity,3 wins & 12 nominations.,0,3,12,15
2115,The Bucket List,3 wins & 4 nominations,0,3,4,7
2116,The Bourne Ultimatum,Won 3 Oscars. 29 wins & 42 nominations total,3,29,42,74
2117,P2,1 nomination.,0,0,1,1
2118,Mr. Magorium's Wonder Emporium,3 nominations.,0,0,3,3
2119,Mr. Brooks,2 nominations,0,0,2,2
2120,Mr. Woodcock,,0,0,0,0
2121,P.S. I Love You,2 wins & 4 nominations.,0,2,4,6
2122,Waitress,6 wins & 16 nominations.,0,6,16,22
2123,Mother of Tears,1 nomination.,0,0,1,1
2124,The Great Debaters,10 wins & 10 nominations,0,10,10,20
2125,Ghost Rider,1 win & 11 nominations.,0,1,11,12
2126,The Brave One,Nominated for 1 Golden Globe. Another 1 win & 6 nominations.,0,1,7,8
2127,The Last Mimzy,7 nominations.,0,0,7,7
2128,Mr. Bean's Holiday,2 nominations.,0,0,2,2
2129,Something New,4 wins & 10 nominations.,0,4,10,14
2130,The Namesake,5 wins & 6 nominations.,0,5,6,11
2131,The Exterminating Angels,,0,0,0,0
2132,Amores asesinos,,0,0,0,0
2133,Deck the Halls,1 win & 8 nominations,0,1,8,9
2134,The Grudge 2,3 nominations.,0,0,3,3
2135,Candy,6 wins & 17 nominations,0,6,17,23
2136,Last Holiday,7 nominations.,0,0,7,7
2137,She's the Man,2 wins & 5 nominations.,0,2,5,7
2138,La Granja,6 wins & 1 nomination.,0,6,1,7
2139,Breaking and Entering,6 nominations.,0,0,6,6
2140,La Dalia Negra,,0,0,0,0
2141,Severance,3 wins & 2 nominations.,0,3,2,5
2142,Sospechas mortales,,0,0,0,0
2143,Southland Tales,1 win & 3 nominations.,0,1,3,4
2144,The Illusionist,Nominated for 1 Oscar. 11 wins & 12 nominations total,1,11,12,24
2145,Destino final 3,,0,0,0,0
2146,Beerfest,1 win & 3 nominations.,0,1,3,4
2147,The Fall,4 wins & 11 nominations.,0,4,11,15
2148,The Good German,Nominated for 1 Oscar. Another 3 wins & 4 nominations.,1,3,4,8
2149,The Good Shepherd,Nominated for 1 Oscar. 2 wins & 13 nominations total,1,2,13,16
2150,Diamante de sangre,,0,0,0,0
2151,Despu�s de la boda,,0,0,0,0
2152,Bug,1 win & 6 nominations,0,1,6,7
2153,Wristcutters: A Love Story,9 wins & 6 nominations.,0,9,6,15
2154,Hollywoodland,Nominated for 1 Golden Globe. Another 3 wins & 7 nominations.,0,3,8,11
2155,Shortbus,7 wins & 9 nominations.,0,7,9,16
2156,The Texas Chainsaw Massacre: The Beginning,6 nominations.,0,0,6,6
2157,The Fountain,9 wins & 39 nominations,0,9,39,48
2158,X-Men III: La batalla final,,0,0,0,0
2159,Babel,Won 1 Oscar. Another 42 wins & 136 nominations.,1,42,136,179
2160,Hombre lobo,,0,0,0,0
2161,Bobby,6 wins & 25 nominations.,0,6,25,31
2162,World Trade Center,4 wins & 12 nominations.,0,4,12,16
2163,Deja Vu,1 win & 6 nominations,0,1,6,7
2164,Zoom,4 wins & 8 nominations.,0,4,8,12
2165,The Foot Fist Way,1 win.,0,1,0,1
2166,Smokin' Aces,4 wins.,0,4,0,4
2167,Infamous,3 wins & 2 nominations.,0,3,2,5
2168,Lady in the Water,10 wins & 11 nominations,0,10,11,21
2169,The Fast and the Furious: Tokyo Drift,1 win & 4 nominations.,0,1,4,5
2170,Inside Man,5 wins & 12 nominations.,0,5,12,17
2171,The Unknown Woman,21 wins & 26 nominations.,0,21,26,47
2172,This Is England,Nominated for 1 BAFTA Film Award. Another 14 wins & 15 nominations.,0,14,16,30
2173,The Wicker Man,2 wins & 6 nominations,0,2,6,8
2174,Talladega Nights: The Ballad of Ricky Bobby,8 wins & 9 nominations.,0,8,9,17
2175,Another Gay Movie,2 wins & 1 nomination.,0,2,1,3
2176,The Sentinel,2 nominations,0,0,2,2
2177,Taxidermia,9 wins & 5 nominations.,0,9,5,14
2178,Children of Men,Nominated for 3 Oscars. Another 49 wins & 86 nominations.,3,49,86,138
2179,Tell No One,,0,0,0,0
2180,Tenacious D in The Pick of Destiny,2 nominations.,0,0,2,2
2181,Serpientes a bordo,,0,0,0,0
2182,The Hills Have Eyes,2 wins & 13 nominations,0,2,13,15
2183,Terror en Silent Hill,,0,0,0,0
2184,The Wind That Shakes the Barley,7 wins & 24 nominations.,0,7,24,31
2185,The Ultimate Gift,3 wins.,0,3,0,3
2186,The Holiday,2 wins & 11 nominations,0,2,11,13
2187,The Pink Panther,1 win & 8 nominations.,0,1,8,9
2188,Apocalypto,Nominated for 3 Oscars. Another 9 wins & 20 nominations.,3,9,20,32
2189,The Break-Up,3 wins & 5 nominations,0,3,5,8
2190,Aquamarine,1 win & 5 nominations.,0,1,5,6
2191,The Ant Bully,1 win & 4 nominations.,0,1,4,5
2192,Arthur and the Invisibles,,0,0,0,0
2193,John Tucker Must Die,2 wins & 2 nominations.,0,2,2,4
2194,The Astronaut Farmer,,0,0,0,0
2195,The Prestige,Nominated for 2 Oscars. 6 wins & 45 nominations total,2,6,45,53
2196,The History Boys,Nominated for 2 BAFTA Film Awards. Another 2 wins & 13 nominations.,0,2,15,17
2197,The Benchwarmers,7 nominations.,0,0,7,7
2198,Click,Nominated for 1 Oscar. 3 wins & 12 nominations total,1,3,12,16
2199,Behind the Mask: The Rise of Leslie Vernon,5 wins & 3 nominations,0,5,3,8
2200,Clerks II,3 wins & 3 nominations,0,3,3,6
2201,Crank,2 wins & 2 nominations.,0,2,2,4
2202,Take the Lead,1 win & 6 nominations,0,1,6,7
2203,"You, Me and Dupree",3 wins & 2 nominations.,0,3,2,5
2204,Ice Age: The Meltdown,8 wins & 16 nominations,0,8,16,24
2205,Starter for 10,1 win & 3 nominations.,0,1,3,4
2206,Cars,Nominated for 2 Oscars. Another 28 wins & 32 nominations.,2,28,32,62
2207,Date Movie,4 wins & 1 nomination,0,4,1,5
2208,Stay Alive,,0,0,0,0
2209,Step Up,1 win & 3 nominations,0,1,3,4
2210,Cashback,3 wins.,0,3,0,3
2211,Casino Royale,Won 1 BAFTA Film Award. Another 26 wins & 44 nominations.,0,27,44,71
2212,The Devil Wears Prada,Nominated for 2 Oscars. Another 19 wins & 51 nominations.,2,19,51,72
2213,The Departed,Won 4 Oscars. 97 wins & 141 nominations total,4,97,141,242
2214,Catch and Release,,0,0,0,0
2215,The Dead Girl,2 wins & 4 nominations.,0,2,4,6
2216,300,19 wins & 55 nominations.,0,19,55,74
2217,Stranger Than Fiction,3 wins & 15 nominations,0,3,15,18
2218,16 Blocks,2 nominations.,0,0,2,2
2219,DOA: Dead or Alive,1 nomination,0,0,1,1
2220,Borat: Cultural Learnings of America for Make Benefit Glorious Nation of Kazakhstan,Nominated for 1 Oscar. 20 wins & 34 nominations total,1,20,34,55
2221,Curse of the Golden Flower,Nominated for 1 Oscar. Another 20 wins & 33 nominations.,1,20,33,54
2222,Curious George,1 nomination.,0,0,1,1
2223,Cuentos de Terramar,,0,0,0,0
2224,The Da Vinci Code,8 wins & 21 nominations.,0,8,21,29
2225,The Covenant,,0,0,0,0
2226,Superman Returns,Nominated for 1 Oscar. Another 12 wins & 46 nominations.,1,12,46,59
2227,The Omen,Won 1 Oscar. Another 4 wins & 8 nominations.,1,4,8,13
2228,Idiocracy,1 nomination,0,0,1,1
2229,Charlotte's Web,10 wins & 11 nominations.,0,10,11,21
2230,Annapolis,,0,0,0,0
2231,Criaturas rastreras,,0,0,0,0
2232,Just My Luck,7 nominations.,0,0,7,7
2233,Seraphim Falls,1 win & 1 nomination,0,1,1,2
2234,Poultrygeist: Night of the Chicken Dead,,0,0,0,0
2235,Eragon,1 win & 6 nominations,0,1,6,7
2236,One Night with the King,2 wins.,0,2,0,2
2237,Flicka,3 nominations.,0,0,3,3
2238,RV,1 win & 2 nominations,0,1,2,3
2239,Blind Dating,,0,0,0,0
2240,Madea's Family Reunion,7 nominations.,0,0,7,7
2241,Open Season,1 win & 10 nominations,0,1,10,11
2242,Priceless,1 win & 1 nomination.,0,1,1,2
2243,Happy Feet,Won 1 Oscar. Another 19 wins & 26 nominations.,1,19,26,46
2244,Alex Rider: Operation Stormbreaker,,0,0,0,0
2245,Goya's Ghosts,2 wins & 5 nominations.,0,2,5,7
2246,The Lake House,2 wins & 2 nominations,0,2,2,4
2247,When a Stranger Calls,3 nominations,0,0,3,3
2248,Al otro lado del mundo,,0,0,0,0
2249,The Santa Clause 3: The Escape Clause,4 wins & 9 nominations.,0,4,9,13
2250,Mi mascota es un zombie,,0,0,0,0
2251,Rang De Basanti,37 wins & 30 nominations total,0,37,30,67
2252,Employee of the Month,2 nominations.,0,0,2,2
2253,Ultraviolet,1 win & 2 nominations.,0,1,2,3
2254,Flushed Away,Nominated for 1 BAFTA Film Award. Another 7 wins & 14 nominations.,0,7,15,22
2255,Miami Vice,1 win & 9 nominations,0,1,9,10
2256,Flyboys,2 wins & 3 nominations.,0,2,3,5
2257,Notes on a Scandal,Nominated for 4 Oscars. Another 15 wins & 70 nominations.,4,15,70,89
2258,Penelope,,0,0,0,0
2259,Lucky Number Slevin,5 wins & 4 nominations.,0,5,4,9
2260,The Queen,Won 1 Oscar. 96 wins & 97 nominations total,1,96,97,194
2261,Loving Annabelle,10 wins.,0,10,0,10
2262,Big Momma's House 2,1 win & 5 nominations.,0,1,5,6
2263,A Guide to Recognizing Your Saints,8 wins & 9 nominations.,0,8,9,17
2264,Hatchet,6 wins & 1 nomination.,0,6,1,7
2265,Accepted,4 nominations.,0,0,4,4
2266,Flags of our Fathers,Nominated for 2 Oscars. 16 wins & 28 nominations total,2,16,28,46
2267,Akeelah and the Bee,11 wins & 15 nominations.,0,11,15,26
2268,El imperio,,0,0,0,0
2269,Underworld: Evolution,2 wins & 6 nominations.,0,2,6,8
2270,Factory Girl,1 nomination,0,0,1,1
2271,Failure to Launch,5 nominations,0,0,5,5
2272,"Paris, je t'aime",3 wins & 2 nominations.,0,3,2,5
2273,Marie Antoinette,Won 1 Oscar. Another 18 wins & 23 nominations.,1,18,23,42
2274,Gridiron Gang,,0,0,0,0
2275,The Last King of Scotland,Won 1 Oscar. 49 wins & 32 nominations total,1,49,32,82
2276,Grandma's Boy,1 nomination.,0,0,1,1
2277,Black Snake Moan,1 win & 7 nominations,0,1,7,8
2278,The Last Kiss,1 win & 4 nominations.,0,1,4,5
2279,United 93,Nominated for 2 Oscars. Another 29 wins & 55 nominations.,2,29,55,86
2280,Fast Food Nation,1 win & 3 nominations.,0,1,3,4
2281,Facing the Giants,,0,0,0,0
2282,Paprika,,0,0,0,0
2283,Find Me Guilty,1 win & 2 nominations.,0,1,2,3
2284,Pan's Labyrinth,,0,0,0,0
2285,Black Christmas,2 wins & 2 nominations.,0,2,2,4
2286,Pirates of the Caribbean: Dead Man's Chest,Won 1 Oscar. 45 wins & 54 nominations total,1,45,54,100
2287,Pisando firme,,0,0,0,0
2288,Half Nelson,Nominated for 1 Oscar. Another 29 wins & 47 nominations.,1,29,47,77
2289,Firewall,3 nominations.,0,0,3,3
2290,Poseidon,Nominated for 1 Oscar. Another 6 nominations.,1,0,6,7
2291,See No Evil,3 nominations,0,0,3,3
2292,Unaccompanied Minors,1 win & 3 nominations.,0,1,3,4
2293,Everyone's Hero,,0,0,0,0
2294,Man of the Year,1 nomination.,0,0,1,1
2295,Over the Hedge,7 wins & 26 nominations.,0,7,26,33
2296,The Marine,,0,0,0,0
2297,Black Book,Nominated for 1 BAFTA Film Award. Another 13 wins & 22 nominations.,0,13,23,36
2298,A Good Year,1 win & 2 nominations.,0,1,2,3
2299,Peaceful Warrior,,0,0,0,0
2300,Basic Instinct 2,8 wins & 6 nominations,0,8,6,14
2301,Running with Scissors,3 wins & 7 nominations.,0,3,7,10
2302,Tristan + Isolde,,0,0,0,0
2303,Little Miss Sunshine,Won 2 Oscars. Another 70 wins & 112 nominations.,2,70,112,184
2304,My Super Ex-Girlfriend,1 win & 1 nomination.,0,1,1,2
2305,Little Children,Nominated for 3 Oscars. Another 20 wins & 58 nominations.,3,20,58,81
2306,We Are Marshall,1 nomination.,0,0,1,1
2307,Amazing Grace,3 wins & 6 nominations.,0,3,6,9
2308,Miss Potter,Nominated for 1 Golden Globe. Another 5 wins & 4 nominations.,0,5,5,10
2309,Fur: An Imaginary Portrait of Diane Arbus,2 wins.,0,2,0,2
2310,Glory Road,2 wins & 3 nominations.,0,2,3,5
2311,Vida salvaje,,0,0,0,0
2312,Mission: Impossible III,7 wins & 14 nominations.,0,7,14,21
2313,A Scanner Darkly,4 wins & 21 nominations,0,4,21,25
2314,Nacho Libre,1 win & 11 nominations,0,1,11,12
2315,Garfield 2,,0,0,0,0
2316,American Dreamz,1 nomination.,0,0,1,1
2317,Dreamgirls,Won 2 Oscars. 67 wins & 92 nominations total,2,67,92,161
2318,Volver,Nominated for 1 Oscar. Another 61 wins & 93 nominations.,1,61,93,155
2319,Monster House,Nominated for 1 Oscar. Another 4 wins & 22 nominations.,1,4,22,27
2320,Letters from Iwo Jima,Won 1 Oscar. Another 23 wins & 39 nominations.,1,23,39,63
2321,Let's Go to Prison,,0,0,0,0
2322,Saw III,1 win & 9 nominations.,0,1,9,10
2323,Scary Movie 4,1 win & 3 nominations,0,1,3,4
2324,School for Scoundrels,2 nominations.,0,0,2,2
2325,Scoop,2 nominations,0,0,2,2
2326,Lejos de ella,,0,0,0,0
2327,Littleman,,0,0,0,0
2328,Rocky Balboa,4 nominations,0,0,4,4
2329,All the King's Men,2 wins & 4 nominations,0,2,4,6
2330,Friends with Money,2 wins & 2 nominations.,0,2,2,4
2331,ATL,7 nominations.,0,0,7,7
2332,Rescue Dawn,1 win & 6 nominations.,0,1,6,7
2333,El Perfume: Historia de un asesino,,0,0,0,0
2334,Van Wilder 2: The Rise of Taj,1 nomination.,0,0,1,1
2335,Night at the Museum,2 wins & 8 nominations.,0,2,8,10
2336,Eight Below,2 wins & 2 nominations.,0,2,2,4
2337,The Pursuit of Happyness,Nominated for 1 Oscar. Another 12 wins & 25 nominations.,1,12,25,38
2338,The Lives of Others,Won 1 Oscar. Another 79 wins & 38 nominations.,1,79,38,118
2339,The Science of Sleep,,0,0,0,0
2340,Turistas,1 win & 1 nomination,0,1,1,2
2341,The Descent,8 wins & 22 nominations,0,8,22,30
2342,The Hitchhiker's Guide to the Galaxy,1 win & 10 nominations,0,1,10,11
2343,The Ring Two,2 wins & 11 nominations.,0,2,11,13
2344,Mr. & Mrs. Smith,9 wins & 18 nominations.,0,9,18,27
2345,The Death of Mr. Lazarescu,30 wins & 14 nominations.,0,30,14,44
2346,The Greatest Game Ever Played,3 nominations.,0,0,3,3
2347,The Perfect Man,2 wins & 3 nominations.,0,2,3,5
2348,Me and You and Everyone We Know,22 wins & 15 nominations,0,22,15,37
2349,Munich,Nominated for 5 Oscars. Another 14 wins & 70 nominations.,5,14,70,89
2350,Mrs Henderson Presents,,0,0,0,0
2351,Paradise Now,Nominated for 1 Oscar. Another 13 wins & 16 nominations.,1,13,16,30
2352,Waiting...,,0,0,0,0
2353,Unleashed,1 nomination,0,0,1,1
2354,The Great Raid,1 nomination.,0,0,1,1
2355,xXx: State of the Union,1 nomination,0,0,1,1
2356,The Ringer,1 nomination,0,0,1,1
2357,Valiant,2 nominations.,0,0,2,2
2358,The Devil's Rejects,10 wins & 8 nominations.,0,10,8,18
2359,The Upside of Anger,5 wins & 13 nominations.,0,5,13,18
2360,The Exorcism of Emily Rose,4 wins & 9 nominations.,0,4,9,13
2361,Wedding Crashers,11 wins & 11 nominations.,0,11,11,22
2362,The Brothers Grimm,4 wins & 5 nominations.,0,4,5,9
2363,The Pacifier,1 win & 10 nominations.,0,1,10,11
2364,Nanny McPhee,3 wins & 4 nominations.,0,3,4,7
2365,Jarhead,6 wins & 12 nominations.,0,6,12,18
2366,War of the Worlds,Nominated for 3 Oscars. Another 16 wins & 46 nominations.,3,16,46,65
2367,The Longest Yard,3 wins & 17 nominations,0,3,17,20
2368,The Constant Gardener,Won 1 Oscar. 35 wins & 69 nominations total,1,35,69,105
2369,The Skeleton Key,5 nominations,0,0,5,5
2370,Venom,3 wins & 9 nominations.,0,3,9,12
2371,The Family Stone,4 wins & 8 nominations,0,4,8,12
2372,Memoirs of a Geisha,Won 3 Oscars. Another 29 wins & 47 nominations.,3,29,47,79
2373,The Squid and the Whale,Nominated for 1 Oscar. 23 wins & 49 nominations total,1,23,49,73
2374,Oliver Twist,2 wins & 4 nominations,0,2,4,6
2375,The Fog,1 win & 2 nominations.,0,1,2,3
2376,Must Love Dogs,1 nomination.,0,0,1,1
2377,The Chumscrubber,1 nomination.,0,0,1,1
2378,"The Chronicles of Narnia: The Lion, the Witch and the Wardrobe",Won 1 Oscar. Another 17 wins & 46 nominations.,1,17,46,64
2379,The Legend of Zorro,2 wins & 3 nominations.,0,2,3,5
2380,Into the Blue,1 win & 2 nominations.,0,1,2,3
2381,Zathura: A Space Adventure,2 wins & 3 nominations,0,2,3,5
2382,The Dukes of Hazzard,5 wins & 14 nominations,0,5,14,19
2383,The Curse of the Were-Rabbit,Won 1 Oscar. Another 39 wins & 25 nominations.,1,39,25,65
2384,The Cave,,0,0,0,0
2385,V for Vendetta,7 wins & 29 nominations,0,7,29,36
2386,Mirrormask,5 wins & 2 nominations,0,5,2,7
2387,Miss Congeniality 2: Armed and Fabulous,,0,0,0,0
2388,North Country,Nominated for 2 Oscars. Another 5 wins & 18 nominations.,2,5,18,25
2389,Serenity,9 wins & 10 nominations,0,9,10,19
2390,The Man,1 win & 1 nomination.,0,1,1,2
2391,Lord of War,2 wins & 3 nominations,0,2,3,5
2392,La mujer de mi hermano,,0,0,0,0
2393,La marca de la bestia,,0,0,0,0
2394,Robots,2 wins & 22 nominations.,0,2,22,24
2395,Revolver,1 win,0,1,0,1
2396,Three Burials,5 wins & 9 nominations.,0,5,9,14
2397,La casa de cera,,0,0,0,0
2398,London,1 win & 1 nomination.,0,1,1,2
2399,Tsotsi,Won 1 Oscar. Another 22 wins & 18 nominations.,1,22,18,41
2400,Lords of Dogtown,1 win & 7 nominations,0,1,7,8
2401,Tideland,1 win & 12 nominations.,0,1,12,13
2402,White Noise,1 win & 2 nominations,0,1,2,3
2403,Son of the Mask,7 wins & 12 nominations.,0,7,12,19
2404,Sophie Scholl: The Final Days,,0,0,0,0
2405,L'enfant,3 nominations,0,0,3,3
2406,The Notorious Bettie Page,4 nominations,0,0,4,4
2407,The Producers,Won 1 Oscar. Another 2 wins & 5 nominations.,1,2,5,8
2408,Rent,1 win & 21 nominations,0,1,21,22
2409,The Island,1 win & 6 nominations.,0,1,6,7
2410,Star Wars: Episode III - Revenge of the Sith,Nominated for 1 Oscar. Another 26 wins & 62 nominations.,1,26,62,89
2411,Thumbsucker,5 wins & 5 nominations,0,5,5,10
2412,Tierra de los muertos,,0,0,0,0
2413,The Sisterhood of the Traveling Pants,1 win & 14 nominations.,0,1,14,15
2414,The Interpreter,3 wins & 2 nominations,0,3,2,5
2415,Transamerica,Nominated for 2 Oscars. Another 32 wins & 24 nominations.,2,32,24,58
2416,Wolf Creek,3 wins & 26 nominations.,0,3,26,29
2417,Shadowboxer,1 win & 2 nominations.,0,1,2,3
2418,Saw II,4 wins & 11 nominations,0,4,11,15
2419,Last Days,3 wins & 5 nominations.,0,3,5,8
2420,Winter Passing,,0,0,0,0
2421,Transporter 2,,0,0,0,0
2422,Shopgirl,1 win & 7 nominations.,0,1,7,8
2423,Sahara,2 wins & 5 nominations,0,2,5,7
2424,Si te casas... te mato,,0,0,0,0
2425,Little Manhattan,,0,0,0,0
2426,Russian Dolls,1 win & 4 nominations.,0,1,4,5
2427,Sin City,38 wins & 54 nominations.,0,38,54,92
2428,Lady Vengeance,12 wins & 13 nominations.,0,12,13,25
2429,Rumor Has It...,,0,0,0,0
2430,The New World,Nominated for 1 Oscar. Another 6 wins & 33 nominations.,1,6,33,40
2431,Time to Leave,,0,0,0,0
2432,Romance & Cigarettes,1 nomination.,0,0,1,1
2433,Roll Bounce,2 wins & 6 nominations.,0,2,6,8
2434,Sky High,1 nomination.,0,0,1,1
2435,Lovewrecked,,0,0,0,0
2436,Stay,1 nomination.,0,0,1,1
2437,Stealth,2 nominations.,0,0,2,2
2438,The White Countess,2 nominations.,0,0,2,2
2439,Keeping Mum,1 win & 5 nominations,0,1,5,6
2440,Man-Thing,,0,0,0,0
2441,Just Like Heaven,1 win & 1 nomination,0,1,1,2
2442,Manderlay,1 win & 16 nominations,0,1,16,17
2443,Just Friends,3 nominations.,0,0,3,3
2444,Thank You for Smoking,12 wins & 32 nominations,0,12,32,44
2445,"Yours, Mine & Ours",2 wins & 4 nominations.,0,2,4,6
2446,The 40-Year-Old Virgin,10 wins & 19 nominations,0,10,19,29
2447,The Wedding Date,,0,0,0,0
2448,Where the Truth Lies,2 wins & 10 nominations.,0,2,10,12
2449,The Weather Man,,0,0,0,0
2450,The Adventures of Sharkboy and Lavagirl 3-D,1 win & 10 nominations,0,1,10,11
2451,Junebug,Nominated for 1 Oscar. Another 21 wins & 27 nominations.,1,21,27,49
2452,The Amityville Horror,2 wins & 4 nominations.,0,2,4,6
2453,Marilyn Hotchkiss' Ballroom Dancing & Charm School,1 nomination.,0,0,1,1
2454,The Aura,11 wins & 7 nominations.,0,11,7,18
2455,Joyeux Noel,Nominated for 1 Oscar. Another 6 wins & 11 nominations.,1,6,11,18
2456,Match Point,Nominated for 1 Oscar. 12 wins & 32 nominations total,1,12,32,45
2457,The Ballad of Jack and Rose,3 wins & 6 nominations.,0,3,6,9
2458,Tamara,1 nomination.,0,0,1,1
2459,Kicking & Screaming,6 nominations,0,0,6,6
2460,The Quiet,1 win.,0,1,0,1
2461,Pretty Persuasion,1 win & 2 nominations.,0,1,2,3
2462,The Zodiac,,0,0,0,0
2463,Two for the Money,2 nominations.,0,0,2,2
2464,Regresiones de un hombre muerto,,0,0,0,0
2465,The Matador,1 win & 6 nominations,0,1,6,7
2466,Red Eye,2 wins & 9 nominations.,0,2,9,11
2467,Rebound,2 nominations.,0,0,2,2
2468,Strangers with Candy,,0,0,0,0
2469,Madagascar,4 wins & 32 nominations.,0,4,32,36
2470,Kiss Kiss Bang Bang,5 wins & 16 nominations.,0,5,16,21
2471,Kinky Boots,1 win & 7 nominations.,0,1,7,8
2472,Racing Stripes,3 nominations.,0,0,3,3
2473,The World's Fastest Indian,11 wins & 6 nominations.,0,11,6,17
2474,Kingdom of Heaven,5 wins & 15 nominations.,0,5,15,20
2475,King Kong,Won 3 Oscars. Another 43 wins & 104 nominations.,3,43,104,150
2476,Supercross,,0,0,0,0
2477,Syriana,Won 1 Oscar. Another 12 wins & 30 nominations.,1,12,30,43
2478,Prime,1 nomination,0,0,1,1
2479,Pride & Prejudice,Won 1 BAFTA Film Award. Another 9 wins & 23 nominations.,0,10,23,33
2480,Walk the Line,Won 1 Oscar. Another 43 wins & 48 nominations.,1,43,48,92
2481,�on Flux,,0,0,0,0
2482,Doom,3 nominations.,0,0,3,3
2483,Feast,1 win.,0,1,0,1
2484,Corpse Bride,Nominated for 1 Oscar. 9 wins & 30 nominations total,1,9,30,40
2485,Dirty Deeds,,0,0,0,0
2486,Dirty Love,4 wins & 7 nominations.,0,4,7,11
2487,Cinderella Man,Nominated for 3 Oscars. Another 16 wins & 42 nominations.,3,16,42,61
2488,Imagine Me & You,,0,0,0,0
2489,Are We There Yet?,1 win & 8 nominations.,0,1,8,9
2490,Brokeback Mountain,Won 3 Oscars. Another 138 wins & 132 nominations.,3,138,132,273
2491,BloodRayne,4 wins & 11 nominations,0,4,11,15
2492,An American Haunting,5 nominations.,0,0,5,5
2493,Broken Flowers,5 wins & 14 nominations.,0,5,14,19
2494,Chicken Little,4 wins & 15 nominations.,0,4,15,19
2495,Harry Potter and the Goblet of Fire,Nominated for 1 Oscar. Another 13 wins & 43 nominations.,1,13,43,57
2496,Elizabethtown,2 wins & 4 nominations.,0,2,4,6
2497,Dominion: Prequel to the Exorcist,,0,0,0,0
2498,Cheaper by the Dozen 2,1 win & 5 nominations.,0,1,5,6
2499,Goal! The Dream Begins,1 win & 6 nominations.,0,1,6,7
2500,Domino,2 wins.,0,2,0,2
2501,Elektra,2 nominations.,0,0,2,2
2502,Bewitched,2 wins & 13 nominations.,0,2,13,15
2503,Hoodwinked!,1 nomination,0,0,1,1
2504,Brick,11 wins & 23 nominations.,0,11,23,34
2505,Hostel,6 wins & 14 nominations.,0,6,14,20
2506,Asylum,2 wins.,0,2,0,2
2507,Everything Is Illuminated,7 wins & 6 nominations,0,7,6,13
2508,Assault on Precinct 13,1 win & 2 nominations.,0,1,2,3
2509,Derailed,,0,0,0,0
2510,Boogeyman,,0,0,0,0
2511,Coach Carter,3 wins & 15 nominations,0,3,15,18
2512,Hard Candy,10 wins & 13 nominations,0,10,13,23
2513,Beowulf & Grendel,3 wins & 19 nominations,0,3,19,22
2514,Hostage,4 nominations.,0,0,4,4
2515,Get Rich or Die Tryin',6 wins & 3 nominations.,0,6,3,9
2516,Fun with Dick and Jane,1 win & 7 nominations.,0,1,7,8
2517,Ice Princess,,0,0,0,0
2518,Alone in the Dark,4 wins & 3 nominations.,0,4,3,7
2519,Deuce Bigalow: European Gigolo,3 wins & 10 nominations.,0,3,10,13
2520,Constantine,2 wins & 10 nominations,0,2,10,12
2521,Black,56 wins & 4 nominations.,0,56,4,60
2522,Diary of a Mad Black Woman,13 wins & 13 nominations.,0,13,13,26
2523,Breakfast on Pluto,6 wins & 17 nominations.,0,6,17,23
2524,Four Brothers,5 wins & 9 nominations,0,5,9,14
2525,Because of Winn-Dixie,2 nominations.,0,0,2,2
2526,A Lot Like Love,1 win & 3 nominations.,0,1,3,4
2527,Harsh Times,2 nominations.,0,0,2,2
2528,Casanova,5 wins & 3 nominations.,0,5,3,8
2529,Cry_Wolf,,0,0,0,0
2530,A History of Violence,Nominated for 2 Oscars. 37 wins & 84 nominations total,2,37,84,123
2531,Adam's Apples,20 wins & 13 nominations.,0,20,13,33
2532,An Unfinished Life,3 wins & 1 nomination,0,3,1,4
2533,Capote,Won 1 Oscar. Another 58 wins & 89 nominations.,1,58,89,148
2534,Be Cool,1 win & 13 nominations.,0,1,13,14
2535,Guess Who,16 nominations,0,0,16,16
2536,Flightplan,2 wins & 6 nominations,0,2,6,8
2537,13 Tzameti,11 wins & 4 nominations.,0,11,4,15
2538,Hide and Seek,1 win & 5 nominations.,0,1,5,6
2539,Dreamer: Inspired by a True Story,,0,0,0,0
2540,Angel-A,,0,0,0,0
2541,Green Street Hooligans,,0,0,0,0
2542,A Sound of Thunder,4 nominations,0,0,4,4
2543,Bad News Bears,1 win & 4 nominations.,0,1,4,5
2544,"Good Night, and Good Luck.",Nominated for 6 Oscars. 38 wins & 129 nominations total,6,38,129,173
2545,Hitch,4 wins & 24 nominations,0,4,24,28
2546,Batman Begins,Nominated for 1 Oscar. 13 wins & 79 nominations total,1,13,79,93
2547,Cach�,,0,0,0,0
2548,In Her Shoes,1 win & 7 nominations,0,1,7,8
2549,Dark Water,6 nominations.,0,0,6,6
2550,Herbie Fully Loaded,2 wins & 6 nominations.,0,2,6,8
2551,Charlie and the Chocolate Factory,Nominated for 1 Oscar. 15 wins & 52 nominations total,1,15,52,68
2552,Beauty Shop,15 nominations,0,0,15,15
2553,The Merchant of Venice,2 wins & 7 nominations total,0,2,7,9
2554,The Terminal,7 wins & 8 nominations.,0,7,8,15
2555,House of D,,0,0,0,0
2556,The Life Aquatic with Steve Zissou,3 wins & 10 nominations,0,3,10,13
2557,Steamboy,3 wins.,0,3,0,3
2558,First Daughter,,0,0,0,0
2559,Dear Frankie,8 wins & 8 nominations.,0,8,8,16
2560,Exorcist: The Beginning,6 nominations,0,0,6,6
2561,Primer,3 wins & 7 nominations.,0,3,7,10
2562,The Woodsman,7 wins & 20 nominations,0,7,20,27
2563,Head in the Clouds,7 wins & 5 nominations.,0,7,5,12
2564,Soul Plane,1 nomination.,0,0,1,1
2565,P.S.,3 wins & 4 nominations.,0,3,4,7
2566,As It Is in Heaven,Nominated for 1 Oscar. Another 2 wins & 11 nominations.,1,2,11,14
2567,Around the World in 80 Days,2 wins & 2 nominations,0,2,2,4
2568,The Whole Ten Yards,1 win & 1 nomination.,0,1,1,2
2569,Kinsey,Nominated for 1 Oscar. Another 17 wins & 50 nominations.,1,17,50,68
2570,Spider-Man 2,Won 1 Oscar. Another 24 wins & 60 nominations.,1,24,60,85
2571,De-Lovely,Nominated for 2 Golden Globes. Another 2 wins & 11 nominations.,0,2,13,15
2572,The Manchurian Candidate,Nominated for 1 BAFTA Film Award. Another 1 win & 11 nominations.,0,1,12,13
2573,Stage Beauty,4 wins & 1 nomination.,0,4,1,5
2574,Beyond the Sea,Nominated for 1 Golden Globe. Another 6 nominations.,0,0,7,7
2575,EuroTrip,2 nominations.,0,0,2,2
2576,Dawn of the Dead,1 win & 17 nominations.,0,1,17,18
2577,Starsky & Hutch,3 wins & 10 nominations,0,3,10,13
2578,Finding Neverland,Won 1 Oscar. Another 18 wins & 81 nominations.,1,18,81,100
2579,Fat Albert,1 nomination.,0,0,1,1
2580,Without a Paddle,,0,0,0,0
2581,Dead Man's Shoes,4 wins & 13 nominations.,0,4,13,17
2582,Palindromes,3 nominations,0,0,3,3
2583,Walking Tall,2 nominations,0,0,2,2
2584,House of Flying Daggers,Nominated for 1 Oscar. Another 26 wins & 73 nominations.,1,26,73,100
2585,King Arthur,4 wins & 8 nominations,0,4,8,12
2586,Spartan,,0,0,0,0
2587,A Cinderella Story,6 wins & 8 nominations,0,6,8,14
2588,Spanglish,5 wins & 15 nominations.,0,5,15,20
2589,A Series of Unfortunate Events,Won 1 Oscar. 10 wins & 28 nominations total,1,10,28,39
2590,9 Songs,1 win & 2 nominations.,0,1,2,3
2591,Howl's Moving Castle,Nominated for 1 Oscar. Another 14 wins & 19 nominations.,1,14,19,34
2592,The Village,Nominated for 1 Oscar. Another 4 wins & 23 nominations.,1,4,23,28
2593,Kill Bill: Vol. 2,23 wins & 84 nominations.,0,23,84,107
2594,The Machinist,7 wins & 15 nominations,0,7,15,22
2595,Win a Date with Tad Hamilton!,8 nominations.,0,0,8,8
2596,Wimbledon,1 nomination.,0,0,1,1
2597,Hotel Rwanda,Nominated for 3 Oscars. 16 wins & 49 nominations total,3,16,49,68
2598,Sideways,Won 1 Oscar. Another 121 wins & 91 nominations.,1,121,91,213
2599,Eulogy,,0,0,0,0
2600,The Sea Inside,Won 1 Oscar. Another 67 wins & 38 nominations.,1,67,38,106
2601,Ella Enchanted,1 nomination.,0,0,1,1
2602,Ladder 49,1 win & 7 nominations.,0,1,7,8
2603,Ladies in Lavender,3 nominations.,0,0,3,3
2604,The Polar Express,Nominated for 3 Oscars. Another 5 wins & 23 nominations.,3,5,23,31
2605,White Chicks,3 wins & 13 nominations.,0,3,13,16
2606,Welcome to Mooseport,,0,0,0,0
2607,Bad Education,Nominated for 1 BAFTA Film Award. Another 16 wins & 41 nominations.,0,16,42,58
2608,Secret Window,3 nominations,0,0,3,3
2609,A Good Woman,3 nominations,0,0,3,3
2610,A Love Song for Bobby Long,Nominated for 1 Golden Globe. Another 3 nominations.,0,0,4,4
2611,El aviador,,0,0,0,0
2612,Scooby-Doo 2: Monsters Unleashed,1 win & 4 nominations.,0,1,4,5
2613,Highwaymen,2 nominations.,0,0,2,2
2614,Resident Evil: Apocalypse,6 wins & 3 nominations.,0,6,3,9
2615,Las leyes de atracci�n,,0,0,0,0
2616,District B13,1 win & 1 nomination.,0,1,1,2
2617,Riding the Bullet,1 nomination.,0,0,1,1
2618,The Prince and Me,,0,0,0,0
2619,The Princess Diaries 2: Royal Engagement,1 win & 2 nominations.,0,1,2,3
2620,Eating Out,10 wins.,0,10,0,10
2621,Downfall,Nominated for 1 Oscar. Another 22 wins & 33 nominations.,1,22,33,56
2622,Saw,8 wins & 10 nominations,0,8,10,18
2623,Saving Face,3 wins & 3 nominations.,0,3,3,6
2624,A Home at the End of the World,1 win & 5 nominations.,0,1,5,6
2625,Saved!,1 win & 6 nominations,0,1,6,7
2626,Barbershop 2: Back in Business,2 wins & 10 nominations.,0,2,10,12
2627,Hidalgo,1 win & 2 nominations.,0,1,2,3
2628,Saint Ralph,6 wins & 9 nominations.,0,6,9,15
2629,Layer Cake,2 wins & 9 nominations.,0,2,9,11
2630,Rory O'Shea Was Here,5 wins & 8 nominations.,0,5,8,13
2631,Dodgeball: A True Underdog Story,2 wins & 9 nominations.,0,2,9,11
2632,Ray,Won 2 Oscars. Another 51 wins & 54 nominations.,2,51,54,107
2633,Eternal Sunshine of the Spotless Mind,Won 1 Oscar. 73 wins & 111 nominations total,1,73,111,185
2634,Enduring Love,4 wins & 12 nominations.,0,4,12,16
2635,The Motorcycle Diaries,Won 1 Oscar. Another 35 wins & 49 nominations.,1,35,49,85
2636,Eros,1 win & 1 nomination,0,1,1,2
2637,Sleepover,1 win & 3 nominations,0,1,3,4
2638,The Stepford Wives,3 wins.,0,3,0,3
2639,Sky Captain and the World of Tomorrow,8 wins & 19 nominations.,0,8,19,27
2640,Kung Fu Hustle,Nominated for 1 BAFTA Film Award. Another 25 wins & 46 nominations.,0,25,47,72
2641,The Notebook,12 wins & 10 nominations.,0,12,10,22
2642,Little Black Book,1 nomination.,0,0,1,1
2643,Envy,3 nominations,0,0,3,3
2644,The SpongeBob SquarePants Movie,1 win & 10 nominations.,0,1,10,11
2645,Hellboy,3 wins & 23 nominations.,0,3,23,26
2646,Wicker Park,1 nomination,0,0,1,1
2647,A Dirty Shame,1 win.,0,1,0,1
2648,We Don't Live Here Anymore,2 wins & 4 nominations,0,2,4,6
2649,Shrek 2,Nominated for 2 Oscars. Another 18 wins & 50 nominations.,2,18,50,70
2650,Before the Fall,8 wins & 6 nominations.,0,8,6,14
2651,Before Sunset,Nominated for 1 Oscar. 9 wins & 32 nominations total,1,9,32,42
2652,Dirty Dancing: Havana Nights,1 nomination,0,0,1,1
2653,Lila Says,,0,0,0,0
2654,The Passion of the Christ,Nominated for 3 Oscars. Another 29 wins & 21 nominations.,3,29,21,53
2655,She Hate Me,1 win & 7 nominations.,0,1,7,8
2656,La isla maldita,,0,0,0,0
2657,Raise Your Voice,2 wins & 3 nominations.,0,2,3,5
2658,Shaun of the Dead,13 wins & 20 nominations.,0,13,20,33
2659,Raising Helen,1 nomination.,0,0,1,1
2660,Shark Tale,Nominated for 1 Oscar. Another 3 wins & 15 nominations.,1,3,15,19
2661,Home on the Range,5 nominations.,0,0,5,5
2662,Shall We Dance,7 nominations.,0,0,7,7
2663,The Perfect Score,1 nomination.,0,0,1,1
2664,The Libertine,2 wins & 8 nominations.,0,2,8,10
2665,Birth,Nominated for 1 Golden Globe. Another 2 wins & 17 nominations.,0,2,18,20
2666,D.E.B.S.,1 win & 2 nominations.,0,1,2,3
2667,The Incredibles,Won 2 Oscars. Another 65 wins & 56 nominations.,2,65,56,123
2668,My Summer of Love,9 wins & 20 nominations.,0,9,20,29
2669,Closer,Nominated for 2 Oscars. Another 22 wins & 48 nominations.,2,22,48,72
2670,Mysterious Skin,5 wins & 9 nominations.,0,5,9,14
2671,Club Dread,,0,0,0,0
2672,Jersey Girl,2 wins & 8 nominations,0,2,8,10
2673,You Got Served,1 win & 5 nominations.,0,1,5,6
2674,"I, Robot",Nominated for 1 Oscar. Another 1 win & 14 nominations.,1,1,14,16
2675,Millions,2 wins & 7 nominations.,0,2,7,9
2676,Million Dollar Baby,Won 4 Oscars. 67 wins & 86 nominations total,4,67,86,157
2677,Vera Drake,Nominated for 3 Oscars. Another 41 wins & 42 nominations.,3,41,42,86
2678,Alfie,Won 1 Golden Globe. Another 6 wins & 8 nominations.,0,7,8,15
2679,Collateral,Nominated for 2 Oscars. Another 22 wins & 71 nominations.,2,22,71,95
2680,Chasing Liberty,5 nominations.,0,0,5,5
2681,Napoleon Dynamite,10 wins & 23 nominations.,0,10,23,33
2682,The Alamo,1 nomination.,0,0,1,1
2683,Alexander,6 wins & 19 nominations.,0,6,19,25
2684,3-Iron,16 wins & 11 nominations.,0,16,11,27
2685,In Good Company,2 wins & 8 nominations.,0,2,8,10
2686,National Treasure,1 win & 9 nominations.,0,1,9,10
2687,Confessions of a Teenage Drama Queen,1 win.,0,1,0,1
2688,Torque,4 nominations.,0,0,4,4
2689,Connie and Carla,1 win,0,1,0,1
2690,The Chronicles of Riddick,5 nominations.,0,0,5,5
2691,Melinda and Melinda,,0,0,0,0
2692,Harold & Kumar Go to White Castle,,0,0,0,0
2693,Johnson Family Vacation,3 nominations.,0,0,3,3
2694,Bobby Jones: Stroke of Genius,1 nomination.,0,0,1,1
2695,Miracle,2 wins & 4 nominations.,0,2,4,6
2696,Along Came Polly,1 win & 9 nominations,0,1,9,10
2697,Godsend,,0,0,0,0
2698,Bridget Jones: The Edge of Reason,11 nominations.,0,0,11,11
2699,The Clearing,1 nomination,0,0,1,1
2700,Twisted,1 win,0,1,0,1
2701,Modigliani,2 nominations.,0,0,2,2
2702,The Butterfly Effect,1 win & 8 nominations.,0,1,8,9
2703,2046,38 wins & 81 nominations.,0,38,81,119
2704,It's All Gone Pete Tong,11 wins & 9 nominations.,0,11,9,20
2705,AVP: Alien vs. Predator,,0,0,0,0
2706,Yu-Gi-Oh!: The Movie,,0,0,0,0
2707,Christmas with the Kranks,3 wins & 4 nominations.,0,3,4,7
2708,Chucky 5: El Hijo de Chucky,,0,0,0,0
2709,The Grudge,2 wins & 10 nominations.,0,2,10,12
2710,Van Helsing,3 wins & 21 nominations.,0,3,21,24
2711,Garden State,13 wins & 39 nominations,0,13,39,52
2712,Ghost in the Shell 2: Innocence,6 wins & 8 nominations.,0,6,8,14
2713,The Bourne Supremacy,5 wins & 22 nominations,0,5,22,27
2714,Turtles Can Fly,23 wins & 7 nominations.,0,23,7,30
2715,Vanity Fair,2 wins & 5 nominations,0,2,5,7
2716,Bride & Prejudice,1 win & 8 nominations.,0,1,8,9
2717,Mr 3000,1 win & 5 nominations,0,1,5,6
2718,Two Brothers,,0,0,0,0
2719,Veer-Zaara,27 wins & 29 nominations.,0,27,29,56
2720,Garfield,1 win & 1 nomination.,0,1,1,2
2721,The Heart Is Deceitful Above All Things,1 win & 2 nominations.,0,1,2,3
2722,Troy,Nominated for 1 Oscar. Another 5 wins & 22 nominations.,1,5,22,28
2723,The Big Bounce,,0,0,0,0
2724,Cellular,2 nominations.,0,0,2,2
2725,A Very Long Engagement,2 wins & 1 nomination.,0,2,1,3
2726,The Day After Tomorrow,Won 1 BAFTA Film Award. Another 5 wins & 12 nominations.,0,6,12,18
2727,Suspect Zero,,0,0,0,0
2728,Undertow,3 wins & 6 nominations.,0,3,6,9
2729,Meet the Fockers,2 wins & 7 nominations,0,2,7,9
2730,I Heart Huckabees,3 wins & 11 nominations.,0,3,11,14
2731,The Door in the Floor,2 wins & 7 nominations.,0,2,7,9
2732,New York Minute,6 nominations,0,0,6,6
2733,Thunderbirds,1 win & 1 nomination,0,1,1,2
2734,Three... Extremes,5 wins & 14 nominations.,0,5,14,19
2735,Mean Girls,7 wins & 25 nominations.,0,7,25,32
2736,Ocean's Twelve,4 wins & 10 nominations,0,4,10,14
2737,The Forgotten,7 nominations.,0,0,7,7
2738,Swades,13 wins & 23 nominations,0,13,23,36
2739,Surviving Christmas,2 wins & 5 nominations.,0,2,5,7
2740,"Julia, una mujer seductora",,0,0,0,0
2741,Blade: Trinity,1 nomination,0,0,1,1
2742,Mean Creek,4 wins & 6 nominations,0,4,6,10
2743,Anacondas: The Hunt for the Blood Orchid,2 nominations.,0,0,2,2
2744,Superbabies: Baby Geniuses 2,13 nominations.,0,0,13,13
2745,Summer Storm,4 wins & 4 nominations.,0,4,4,8
2746,Black Friday,1 win & 4 nominations.,0,1,4,5
2747,Calvaire,4 wins & 3 nominations.,0,4,3,7
2748,Anchorman: The Legend of Ron Burgundy,1 win & 13 nominations.,0,1,13,14
2749,After the Sunset,1 nomination.,0,0,1,1
2750,The Final Cut,1 win & 4 nominations,0,1,4,5
2751,Flight of the Phoenix,2 nominations.,0,0,2,2
2752,The Ladykillers,6 wins & 4 nominations.,0,6,4,10
2753,Agent Cody Banks 2: Destination London,,0,0,0,0
2754,Harry Potter and the Prisoner of Azkaban,Nominated for 2 Oscars. Another 17 wins & 51 nominations.,2,17,51,70
2755,The Girl Next Door,2 wins & 4 nominations.,0,2,4,6
2756,Ma m�re,,0,0,0,0
2757,Team America: World Police,1 win & 11 nominations.,0,1,11,12
2758,Amor o sexo,,0,0,0,0
2759,Night Watch,2 wins & 10 nominations.,0,2,10,12
2760,50 First Dates,6 wins & 10 nominations.,0,6,10,16
2761,Maria Full of Grace,Nominated for 1 Oscar. Another 41 wins & 34 nominations.,1,41,34,76
2762,Catwoman,13 wins & 8 nominations,0,13,8,21
2763,The Chorus,,0,0,0,0
2764,Crash,Won 3 Oscars. Another 63 wins & 112 nominations.,3,63,112,178
2765,Taking Lives,4 nominations,0,0,4,4
2766,13 Going on 30,11 nominations.,0,0,11,11
2767,Juego de viernes por la noche,,0,0,0,0
2768,Catch That Kid,1 nomination.,0,0,1,1
2769,The Return,,0,0,0,0
2770,"Legally Blonde 2: Red, White & Blonde",,0,0,0,0
2771,Master and Commander: The Far Side of the World,Won 2 Oscars. 23 wins & 90 nominations total,2,23,90,115
2772,Grind,,0,0,0,0
2773,Reconstruction,12 wins & 11 nominations.,0,12,11,23
2774,The Rundown,2 wins & 3 nominations,0,2,3,5
2775,The Shape of Things,1 nomination.,0,0,1,1
2776,Masked and Anonymous,1 win.,0,1,0,1
2777,Underworld,1 win & 10 nominations.,0,1,10,11
2778,Gozu,5 wins & 3 nominations.,0,5,3,8
2779,What a Girl Wants,1 win.,0,1,0,1
2780,Dumb and Dumberer: When Harry Met Lloyd,1 win & 7 nominations.,0,1,7,8
2781,Agent Cody Banks,5 nominations.,0,0,5,5
2782,Under the Tuscan Sun,5 nominations.,0,0,5,5
2783,Memories of Murder,31 wins & 4 nominations.,0,31,4,35
2784,Gothika,3 wins & 7 nominations.,0,3,7,10
2785,Elf,2 wins & 7 nominations.,0,2,7,9
2786,Barely Legal,,0,0,0,0
2787,Good Boy!,3 nominations.,0,0,3,3
2788,Elephant,8 wins & 13 nominations.,0,8,13,21
2789,The Room,1 win.,0,1,0,1
2790,Undead,3 wins & 4 nominations.,0,3,4,7
2791,"Goodbye, Dragon Inn",13 wins & 11 nominations.,0,13,11,24
2792,Good Bye Lenin!,36 wins & 22 nominations total,0,36,22,58
2793,Gods and Generals,1 win & 4 nominations,0,1,4,5
2794,A Man Apart,1 nomination,0,0,1,1
2795,Bad Santa,1 win & 12 nominations.,0,1,12,13
2796,Uptown Girls,2 nominations.,0,0,2,2
2797,Duplex,2 nominations,0,0,2,2
2798,My Boss's Daughter,2 nominations.,0,0,2,2
2799,The Singing Detective,1 win & 3 nominations.,0,1,3,4
2800,Tokyo Godfathers,8 wins & 1 nomination.,0,8,1,9
2801,Looney Tunes: Back in Action,10 nominations.,0,0,10,10
2802,Peter Pan,2 nominations.,0,0,2,2
2803,Lutero,,0,0,0,0
2804,Freaky Friday,5 wins & 11 nominations.,0,5,11,16
2805,Paycheck,3 wins & 2 nominations.,0,3,2,5
2806,Anything Else,,0,0,0,0
2807,Timeline,,0,0,0,0
2808,Party Monster,4 nominations.,0,0,4,4
2809,Time of the Wolf,2 wins & 1 nomination.,0,2,1,3
2810,Tierra de osos,,0,0,0,0
2811,Final Destination 2,4 nominations.,0,0,4,4
2812,Finding Nemo,Won 1 Oscar. Another 47 wins & 63 nominations.,1,47,63,111
2813,Lost in Translation,Won 1 Oscar. 97 wins & 132 nominations total,1,97,132,230
2814,Old School,5 nominations.,0,0,5,5
2815,Head of State,10 nominations.,0,0,10,10
2816,Oldboy: Cinco d�as para vengarse,,0,0,0,0
2817,Once Upon a Time in Mexico,3 wins & 6 nominations.,0,3,6,9
2818,Owning Mahowny,3 wins & 5 nominations.,0,3,5,8
2819,Love Actually,Nominated for 2 Golden Globes. Another 10 wins & 27 nominations.,0,10,29,39
2820,Out of Time,5 wins & 7 nominations.,0,5,7,12
2821,Love Don't Cost a Thing,6 nominations.,0,0,6,6
2822,Anger Management,2 wins & 4 nominations.,0,2,4,6
2823,Open Water,2 wins & 6 nominations.,0,2,6,8
2824,Love Me If You Dare,5 wins & 2 nominations.,0,5,2,7
2825,Runaway Jury,1 win & 3 nominations.,0,1,3,4
2826,Open Range,1 win & 5 nominations,0,1,5,6
2827,Ong-Bak: The Thai Warrior,2 wins & 5 nominations.,0,2,5,7
2828,Freddy vs. Jason,2 wins & 11 nominations.,0,2,11,13
2829,The Visual Bible: The Gospel of John,,0,0,0,0
2830,Mona Lisa Smile,6 nominations,0,0,6,6
2831,Pieces of April,Nominated for 1 Oscar. 15 wins & 22 nominations total,1,15,22,38
2832,Girl with a Pearl Earring,Nominated for 3 Oscars. 17 wins & 46 nominations total,3,17,46,66
2833,Bad Boys II,5 wins & 13 nominations.,0,5,13,18
2834,Monster: Asesina en serie,,0,0,0,0
2835,Gigli,12 wins & 13 nominations.,0,12,13,25
2836,Radio,3 wins & 5 nominations,0,3,5,8
2837,Malibu's Most Wanted,3 nominations.,0,0,3,3
2838,All the Real Girls,4 wins & 11 nominations.,0,4,11,15
2839,A Mighty Wind,Nominated for 1 Oscar. 14 wins & 28 nominations total,1,14,28,43
2840,Baadasssss!,3 wins & 11 nominations.,0,3,11,14
2841,Thirteen,Nominated for 1 Oscar. Another 14 wins & 48 nominations.,1,14,48,63
2842,The Station Agent,29 wins & 31 nominations total,0,29,31,60
2843,Mystic River,Won 2 Oscars. Another 54 wins & 144 nominations.,2,54,144,200
2844,M�s all� de las fronteras,,0,0,0,0
2845,Veronica Guerin,Nominated for 1 Golden Globe. Another 3 wins & 13 nominations.,0,3,14,17
2846,From Justin to Kelly,3 wins & 19 nominations,0,3,19,22
2847,Nathalie...,2 nominations.,0,0,2,2
2848,The Texas Chainsaw Massacre,4 wins & 17 nominations,0,4,17,21
2849,American Splendor,Nominated for 1 Oscar. Another 31 wins & 49 nominations.,1,31,49,81
2850,National Security,,0,0,0,0
2851,Evil,Nominated for 1 Oscar. Another 9 wins & 9 nominations.,1,9,9,19
2852,American Wedding,3 wins & 6 nominations.,0,3,6,9
2853,The Triplets of Belleville,Nominated for 2 Oscars. Another 20 wins & 39 nominations.,2,20,39,61
2854,The United States of Leland,1 win & 2 nominations.,0,1,2,3
2855,Ned Kelly,3 wins & 14 nominations.,0,3,14,17
2856,Pirates of the Caribbean: The Curse of the Black Pearl,Nominated for 5 Oscars. Another 38 wins & 99 nominations.,5,38,99,142
2857,Piglet's Big Movie,1 nomination.,0,0,1,1
2858,View from the Top,1 nomination.,0,0,1,1
2859,Rugrats Go Wild,2 nominations.,0,0,2,2
2860,"Spring, Summer, Fall, Winter... and Spring",15 wins & 8 nominations.,0,15,8,23
2861,Matrix Revolutions,5 wins & 36 nominations.,0,5,36,41
2862,Cold Creek Manor,1 nomination.,0,0,1,1
2863,The Blind Swordsman: Zatoichi,,0,0,0,0
2864,The Matrix Reloaded,8 wins & 34 nominations.,0,8,34,42
2865,The Haunted Mansion,1 win & 4 nominations,0,1,4,5
2866,Young Adam,7 wins & 17 nominations.,0,7,17,24
2867,The Best of Youth,,0,0,0,0
2868,Jeepers Creepers II,,0,0,0,0
2869,The Battle of Shaker Heights,,0,0,0,0
2870,Spy Kids 3: Game Over,,0,0,0,0
2871,How to Deal,,0,0,0,0
2872,How to Lose a Guy in 10 Days,1 win & 8 nominations,0,1,8,9
2873,Stander,3 nominations.,0,0,3,3
2874,The Barbarian Invasions,Won 1 Oscar. Another 49 wins & 37 nominations.,1,49,37,87
2875,Kill Bill: Vol. 1,29 wins & 103 nominations total,0,29,103,132
2876,Code 46,4 wins & 10 nominations,0,4,10,14
2877,Coffee and Cigarettes,2 wins & 9 nominations.,0,2,9,11
2878,House of the Dead,2 wins.,0,2,0,2
2879,House of Sand and Fog,Nominated for 3 Oscars. 13 wins & 42 nominations total,3,13,42,58
2880,The Medallion,2 nominations.,0,0,2,2
2881,The Mother,Nominated for 1 BAFTA Film Award. Another 2 wins & 12 nominations.,0,2,13,15
2882,Deliver Us from Eva,4 wins & 12 nominations.,0,4,12,16
2883,Bright Young Things,10 nominations,0,0,10,10
2884,The Brown Bunny,1 win & 6 nominations.,0,1,6,7
2885,Kontroll,19 wins & 5 nominations,0,19,5,24
2886,21 Grams,Nominated for 2 Oscars. 30 wins & 79 nominations total,2,30,79,111
2887,Koi... Mil Gaya,34 wins & 30 nominations.,0,34,30,64
2888,Cradle 2 the Grave,6 nominations.,0,0,6,6
2889,The Memory of a Killer,7 wins & 3 nominations.,0,7,3,10
2890,29 palmas - Pasiones salvajes,,0,0,0,0
2891,Something's Gotta Give,Nominated for 1 Oscar. 8 wins & 13 nominations total,1,8,13,22
2892,Japanese Story,20 wins & 13 nominations.,0,20,13,33
2893,Identity,1 win & 11 nominations.,0,1,11,12
2894,House of 1000 Corpses,4 wins & 8 nominations.,0,4,8,12
2895,Willard,1 win & 5 nominations.,0,1,5,6
2896,Big Fish,Nominated for 1 Oscar. Another 68 nominations.,1,0,68,69
2897,Darkness Falls,1 win & 2 nominations.,0,1,2,3
2898,The Cat in the Hat,7 wins & 22 nominations.,0,7,22,29
2899,Cold Mountain,Won 1 Oscar. 20 wins & 101 nominations total,1,20,101,122
2900,Just Married,8 nominations.,0,0,8,8
2901,Wrong Turn,3 nominations,0,0,3,3
2902,Johnny English,6 nominations,0,0,6,6
2903,The Last Samurai,Nominated for 4 Oscars. Another 20 wins & 63 nominations.,4,20,63,87
2904,I Am David,8 wins & 1 nomination.,0,8,1,9
2905,The In-Laws,,0,0,0,0
2906,Terminator 3: Rise of the Machines,3 wins & 24 nominations.,0,3,24,27
2907,I Capture the Castle,2 wins & 4 nominations,0,2,4,6
2908,X-Men 2,,0,0,0,0
2909,Swimming Pool: juegos perversos,,0,0,0,0
2910,Sylvia,1 win.,0,1,0,1
2911,Tears of the Sun,2 nominations.,0,0,2,2
2912,Taxi 3,,0,0,0,0
2913,The Jungle Book 2,1 win & 9 nominations.,0,1,9,10
2914,The Italian Job,7 wins & 9 nominations,0,7,9,16
2915,The League of Extraordinary Gentlemen,12 nominations.,0,0,12,12
2916,Stuck on You,2 nominations.,0,0,2,2
2917,Confidence,,0,0,0,0
2918,The Lord of the Rings: The Return of the King,Won 11 Oscars. Another 198 wins & 124 nominations.,11,198,124,333
2919,Hulk,3 wins & 14 nominations.,0,3,14,17
2920,I'm Not Scared,14 wins & 18 nominations.,0,14,18,32
2921,Biker Boyz,,0,0,0,0
2922,Wonderland,3 nominations,0,0,3,3
2923,Kangaroo Jack,1 win & 9 nominations.,0,1,9,10
2924,The Human Stain,3 wins & 5 nominations.,0,3,5,8
2925,The Lizzie McGuire Movie,2 wins & 3 nominations.,0,2,3,5
2926,The Life of David Gale,3 nominations.,0,0,3,3
2927,The Recruit,2 nominations,0,0,2,2
2928,Kal Ho Naa Ho,40 wins & 41 nominations,0,40,41,81
2929,Daddy Day Care,1 win & 6 nominations.,0,1,6,7
2930,Strayed,1 win & 3 nominations.,0,1,3,4
2931,I'll Sleep When I'm Dead,1 nomination.,0,0,1,1
2932,The Green Butchers,7 wins & 8 nominations.,0,7,8,15
2933,The Missing,2 wins & 8 nominations.,0,2,8,10
2934,Matchstick Men,5 nominations,0,0,5,5
2935,Camp,6 nominations,0,0,6,6
2936,Shattered Glass,11 wins & 28 nominations.,0,11,28,39
2937,Intolerable Cruelty,3 nominations,0,0,3,3
2938,Shade,,0,0,0,0
2939,Charlie's Angels: Full Throttle,9 wins & 21 nominations.,0,9,21,30
2940,Latter Days,3 wins.,0,3,0,3
2941,The Cooler,Nominated for 1 Oscar. Another 9 wins & 25 nominations.,1,9,25,35
2942,The Core,,0,0,0,0
2943,Hollywood Homicide,1 win,0,1,0,1
2944,Intermission,9 wins & 12 nominations.,0,9,12,21
2945,La vida sin m�,,0,0,0,0
2946,Carandiru,16 wins & 33 nominations,0,16,33,49
2947,Dogville,21 wins & 33 nominations.,0,21,33,54
2948,A Guy Thing,,0,0,0,0
2949,Down with Love,4 wins & 8 nominations,0,4,8,12
2950,Holes,3 wins & 9 nominations.,0,3,9,12
2951,Scary Movie 3,2 wins & 4 nominations.,0,2,4,6
2952,School of Rock,8 wins & 23 nominations.,0,8,23,31
2953,Bringing Down the House,4 wins & 13 nominations,0,4,13,17
2954,The Dreamers,2 wins & 10 nominations.,0,2,10,12
2955,Chalte Chalte,15 nominations.,0,0,15,15
2956,Secondhand Lions,1 win & 6 nominations.,0,1,6,7
2957,Dorm Daze,,0,0,0,0
2958,Seabiscuit,Nominated for 7 Oscars. Another 6 wins & 37 nominations.,7,6,37,50
2959,The Divorce,2 wins.,0,2,0,2
2960,Lara Croft Tomb Raider: The Cradle of Life,1 win & 3 nominations.,0,1,3,4
2961,Dot the I,1 win & 1 nomination.,0,1,1,2
2962,In the Cut,1 win & 2 nominations.,0,1,2,3
2963,Chasing Papi,1 nomination,0,0,1,1
2964,Shanghai Knights,4 nominations.,0,0,4,4
2965,Dreamcatcher,5 nominations.,0,0,5,5
2966,Saints and Soldiers,16 wins & 2 nominations.,0,16,2,18
2967,2 Fast 2 Furious,4 wins & 13 nominations.,0,4,13,17
2968,It's All About Love,3 wins.,0,3,0,3
2969,Zero Day,7 wins & 1 nomination.,0,7,1,8
2970,Sinbad: Legend of the Seven Seas,9 nominations,0,0,9,9
2971,S.W.A.T.,5 wins & 5 nominations,0,5,5,10
2972,The Fighting Temptations,4 wins & 11 nominations.,0,4,11,15
2973,Calendar Girls,Nominated for 1 Golden Globe. Another 2 wins & 15 nominations.,0,2,16,18
2974,B�sico y letal,,0,0,0,0
2975,Cheaper by the Dozen,2 wins & 7 nominations.,0,2,7,9
2976,Bulletproof Monk,1 nomination,0,0,1,1
2977,Bruce Almighty,7 wins & 9 nominations.,0,7,9,16
2978,Honey,8 nominations.,0,0,8,8
2979,Dickie Roberts: Former Child Star,1 win & 1 nomination.,0,1,1,2
2980,The Company,2 nominations.,0,0,2,2
2981,High Tension,,0,0,0,0
2982,The Emperor's Club,2 nominations.,0,0,2,2
2983,Nicholas Nickleby,Nominated for 1 Golden Globe. Another 1 win & 4 nominations.,0,1,5,6
2984,Friday After Next,,0,0,0,0
2985,Catch Me If You Can,Nominated for 2 Oscars. Another 16 wins & 44 nominations.,2,16,44,62
2986,Casarse... est� en griego,,0,0,0,0
2987,May,9 wins & 8 nominations.,0,9,8,17
2988,New Best Friend,,0,0,0,0
2989,The Adventures of Pluto Nash,1 win & 12 nominations.,0,1,12,13
2990,Unfaithful,Nominated for 1 Oscar. Another 3 wins & 15 nominations.,1,3,15,19
2991,The Four Feathers,,0,0,0,0
2992,Cabin Fever,3 wins & 12 nominations.,0,3,12,15
2993,Frida,Won 2 Oscars. Another 15 wins & 47 nominations.,2,15,47,64
2994,Boat Trip,1 win & 8 nominations.,0,1,8,9
2995,Undisputed,2 nominations,0,0,2,2
2996,Confessions of a Dangerous Mind,7 wins & 12 nominations,0,7,12,19
2997,The Importance of Being Earnest,2 wins & 2 nominations.,0,2,2,4
2998,Mondays in the Sun,,0,0,0,0
2999,Undercover Brother,1 win & 7 nominations.,0,1,7,8
3000,The Bourne Identity,3 wins & 6 nominations,0,3,6,9
3001,The Guru,1 nomination.,0,0,1,1
3002,Mr. Deeds,5 wins & 9 nominations,0,5,9,14
3003,Tuck Everlasting,1 win & 3 nominations.,0,1,3,4
3004,All or Nothing,3 wins & 13 nominations.,0,3,13,16
3005,Minority Report,Nominated for 1 Oscar. Another 20 wins & 90 nominations.,1,20,90,111
3006,Brown Sugar,2 wins & 18 nominations.,0,2,18,20
3007,Ghost Ship,1 nomination,0,0,1,1
3008,Morvern Callar,10 wins & 16 nominations.,0,10,16,26
3009,Narc,1 win & 8 nominations,0,1,8,9
3010,City of God,Nominated for 4 Oscars. Another 74 wins & 46 nominations.,4,74,46,124
3011,Moonlight Mile,1 win & 6 nominations,0,1,6,7
3012,City of Ghosts,1 nomination.,0,0,1,1
3013,City by the Sea,1 nomination,0,0,1,1
3014,All About the Benjamins,,0,0,0,0
3015,Two Weeks Notice,2 wins & 3 nominations,0,2,3,5
3016,Chicago,Won 6 Oscars. Another 51 wins & 129 nominations.,6,51,129,186
3017,Gerry,2 wins & 9 nominations.,0,2,9,11
3018,The Good Girl,5 wins & 16 nominations.,0,5,16,21
3019,Mujer fatal,,0,0,0,0
3020,Murder by Numbers,2 nominations.,0,0,2,2
3021,Collateral Damage,,0,0,0,0
3022,Cerca de la libertad,,0,0,0,0
3023,Full Frontal,1 nomination.,0,0,1,1
3024,Changing Lanes,7 nominations.,0,0,7,7
3025,The Hours,Won 1 Oscar. Another 42 wins & 126 nominations.,1,42,126,169
3026,The Hot Chick,4 nominations.,0,0,4,4
3027,The Banger Sisters,1 win & 1 nomination,0,1,1,2
3028,The Country Bears,4 nominations.,0,0,4,4
3029,Men in Black II,4 wins & 16 nominations,0,4,16,20
3030,Trapped,,0,0,0,0
3031,Treasure Planet,Nominated for 1 Oscar. 1 win & 14 nominations total,1,1,14,16
3032,The Count of Monte Cristo,,0,0,0,0
3033,Clockstoppers,,0,0,0,0
3034,Gangs of New York,Nominated for 10 Oscars. Another 50 wins & 125 nominations.,10,50,125,185
3035,Bubba Ho-Tep,7 wins & 10 nominations.,0,7,10,17
3036,Blue Crush,1 win & 7 nominations.,0,1,7,8
3037,Drumline,13 nominations.,0,0,13,13
3038,Bloody Sunday,19 wins & 23 nominations.,0,19,23,42
3039,Deuces Wild,1 win & 1 nomination.,0,1,1,2
3040,Divine Secrets of the Ya-Ya Sisterhood,1 win & 7 nominations.,0,1,7,8
3041,Real Women Have Curves,8 wins & 4 nominations.,0,8,4,12
3042,The Pianist,Won 3 Oscars. 57 wins & 74 nominations total,3,57,74,134
3043,The Slaughter Rule,2 wins & 2 nominations.,0,2,2,4
3044,Dirty Pretty Things,Nominated for 1 Oscar. Another 16 wins & 27 nominations.,1,16,27,44
3045,Showtime,1 win & 6 nominations.,0,1,6,7
3046,Die Another Day,6 wins & 36 nominations.,0,6,36,42
3047,Signs,3 wins & 34 nominations.,0,3,34,37
3048,Enough,4 nominations.,0,0,4,4
3049,Devdas,Nominated for 1 BAFTA Film Award. Another 57 wins & 9 nominations.,0,57,10,67
3050,Queen of the Damned,7 nominations,0,0,7,7
3051,Sendero de sangre,,0,0,0,0
3052,Below,2 nominations,0,0,2,2
3053,Equilibrium,2 nominations.,0,0,2,2
3054,Bend It Like Beckham,17 wins & 20 nominations.,0,17,20,37
3055,Slackers,,0,0,0,0
3056,The New Guy,1 nomination,0,0,1,1
3057,Punch-Drunk Love,14 wins & 37 nominations.,0,14,37,51
3058,Pumpkin,3 nominations.,0,0,3,3
3059,The Sum of All Fears,2 wins & 5 nominations,0,2,5,7
3060,The Sweetest Thing,1 win & 4 nominations.,0,1,4,5
3061,Auto Focus,6 nominations,0,0,6,6
3062,The Mothman Prophecies,1 win & 2 nominations.,0,1,2,3
3063,Serving Sara,,0,0,0,0
3064,Secretary,15 wins & 26 nominations.,0,15,26,41
3065,Snow Dogs,1 win,0,1,0,1
3066,The Rules of Attraction,2 wins & 3 nominations,0,2,3,5
3067,The Reckoning,2 nominations.,0,0,2,2
3068,Russian Ark,10 wins & 15 nominations.,0,10,15,25
3069,The Ring,14 wins & 12 nominations,0,14,12,26
3070,S1m0ne,1 nomination,0,0,1,1
3071,Rollerball,5 wins & 3 nominations,0,5,3,8
3072,Roger Dodger,12 wins & 14 nominations.,0,12,14,26
3073,Drag�n rojo,,0,0,0,0
3074,The Quiet American,Nominated for 1 Oscar. Another 13 wins & 13 nominations.,1,13,13,27
3075,Dragonfly,1 nomination.,0,0,1,1
3076,Barbershop,1 win & 17 nominations.,0,1,17,18
3077,Road to Perdition,Won 1 Oscar. Another 22 wins & 82 nominations.,1,22,82,105
3078,Reign of Fire,1 win & 3 nominations,0,1,3,4
3079,The Salton Sea,1 win.,0,1,0,1
3080,The Santa Clause 2,1 win & 3 nominations.,0,1,3,4
3081,Ballistic: Ecks vs. Sever,5 nominations,0,0,5,5
3082,Eight Crazy Nights,1 win & 5 nominations.,0,1,5,6
3083,The Scorpion King,2 wins & 3 nominations,0,2,3,5
3084,Eight Legged Freaks,1 nomination.,0,0,1,1
3085,The Powerpuff Girls Movie,,0,0,0,0
3086,Scooby-Doo,5 wins & 14 nominations.,0,5,14,19
3087,Resident Evil,7 nominations.,0,0,7,7
3088,El crimen del padre Amaro,Nominated for 1 Oscar. 21 wins & 15 nominations total,1,21,15,37
3089,Secret Things,2 wins.,0,2,0,2
3090,Austin Powers in Goldmember,5 wins & 22 nominations.,0,5,22,27
3091,So Close,1 nomination.,0,0,1,1
3092,Talk to Her,Won 1 Oscar. Another 45 wins & 47 nominations.,1,45,47,93
3093,Open Hearts,12 wins & 12 nominations.,0,12,12,24
3094,Star Wars: Episode II - Attack of the Clones,Nominated for 1 Oscar. Another 19 wins & 64 nominations.,1,19,64,84
3095,Panic Room,1 win & 9 nominations.,0,1,9,10
3096,State Property,,0,0,0,0
3097,Darkness,2 wins & 3 nominations,0,2,3,5
3098,The Magdalene Sisters,Nominated for 1 BAFTA Film Award. Another 18 wins & 14 nominations.,0,18,15,33
3099,Paid in Full,1 nomination.,0,0,1,1
3100,Big Trouble,,0,0,0,0
3101,Dark Blue,4 nominations,0,0,4,4
3102,The Lord of the Rings: The Two Towers,Won 2 Oscars. Another 124 wins & 138 nominations.,2,124,138,264
3103,Orange County,3 nominations.,0,0,3,3
3104,Dahmer,3 nominations.,0,0,3,3
3105,Stuart Little 2,1 win & 4 nominations total,0,1,4,5
3106,Antwone Fisher,19 wins & 22 nominations.,0,19,22,41
3107,One Hour Photo,6 wins & 22 nominations,0,6,22,28
3108,Analyze That,1 win.,0,1,0,1
3109,Blade II,6 wins & 10 nominations.,0,6,10,16
3110,Sweet Home Alabama,3 wins & 6 nominations,0,3,6,9
3111,Sweet Sixteen,10 wins & 17 nominations.,0,10,17,27
3112,Swept Away,8 wins & 8 nominations.,0,8,8,16
3113,Swimfan,,0,0,0,0
3114,Tierra de sue�os,,0,0,0,0
3115,Sympathy for Mr. Vengeance,,0,0,0,0
3116,Blood Work,2 wins,0,2,0,2
3117,Star Trek: Nemesis,1 win & 4 nominations.,0,1,4,5
3118,The Wild Thornberrys Movie,,0,0,0,0
3119,Evelyn,4 wins & 7 nominations.,0,4,7,11
3120,Eye See You,,0,0,0,0
3121,The Time Machine,Nominated for 1 Oscar. 2 wins & 4 nominations total,1,2,4,7
3122,Better Luck Tomorrow,1 win & 2 nominations.,0,1,2,3
3123,Solaris,5 wins & 4 nominations.,0,5,4,9
3124,Asterix and Obelix Meet Cleopatra,,0,0,0,0
3125,The Transporter,,0,0,0,0
3126,Possession,5 wins & 4 nominations.,0,5,4,9
3127,Poolhall Junkies,1 nomination.,0,0,1,1
3128,Death to Smoochy,2 nominations.,0,0,2,2
3129,Sonny,1 nomination.,0,0,1,1
3130,The Tuxedo,2 wins & 1 nomination.,0,2,1,3
3131,Sorority Boys,1 win & 1 nomination,0,1,1,2
3132,Pinocchio,Won 2 Oscars. Another 5 wins.,2,5,0,7
3133,Big Fat Liar,1 win & 3 nominations.,0,1,3,4
3134,Phone Booth,1 win & 8 nominations.,0,1,8,9
3135,Spider,13 wins & 25 nominations.,0,13,25,38
3136,Peter Pan II: Return to Neverland,,0,0,0,0
3137,Spider-Man,Nominated for 2 Oscars. Another 16 wins & 61 nominations.,2,16,61,79
3138,Spirit: Stallion of the Cimarron,Nominated for 1 Oscar. 10 wins & 22 nominations total,1,10,22,33
3139,The Master of Disguise,1 win & 6 nominations.,0,1,6,7
3140,Spun,2 nominations.,0,0,2,2
3141,Spy Kids 2: Island of Lost Dreams,3 wins & 3 nominations.,0,3,3,6
3142,Far from Heaven,Nominated for 4 Oscars. 102 wins & 96 nominations total,4,102,96,202
3143,Feardotcom,3 wins & 3 nominations.,0,3,3,6
3144,The Man Without a Past,Nominated for 1 Oscar. Another 21 wins & 26 nominations.,1,21,26,48
3145,They,1 win & 1 nomination.,0,1,1,2
3146,The Truth About Charlie,2 nominations.,0,0,2,2
3147,L'auberge espagnole,,0,0,0,0
3148,Waking Up in Reno,,0,0,0,0
3149,Halloween: Resurrection,1 win & 1 nomination.,0,1,1,2
3150,I Spy,2 wins & 6 nominations.,0,2,6,8
3151,40 Days and 40 Nights,1 win & 2 nominations.,0,1,2,3
3152,We Were Soldiers,3 wins & 5 nominations,0,3,5,8
3153,La leyenda de las ballenas,,0,0,0,0
3154,Like Mike,1 win & 6 nominations.,0,1,6,7
3155,John Q,2 wins & 8 nominations.,0,2,8,10
3156,White Oleander,3 wins & 7 nominations.,0,3,7,10
3157,Lilo & Stitch,Nominated for 1 Oscar. Another 10 wins & 26 nominations.,1,10,26,37
3158,Windtalkers,3 wins & 4 nominations,0,3,4,7
3159,Lilya 4-Ever,,0,0,0,0
3160,High Crimes,2 nominations.,0,0,2,2
3161,Abandon,1 nomination,0,0,1,1
3162,Life or Something Like It,1 nomination.,0,0,1,1
3163,Ju-on: The Grudge,1 win & 1 nomination.,0,1,1,2
3164,Adaptation.,Won 1 Oscar. 65 wins & 100 nominations total,1,65,100,166
3165,He Loves Me... He Loves Me Not,,0,0,0,0
3166,Hollywood Ending,1 nomination,0,0,1,1
3167,Half Past Dead,4 nominations.,0,0,4,4
3168,About Schmidt,Nominated for 2 Oscars. Another 25 wins & 69 nominations.,2,25,69,96
3169,About a Boy,Nominated for 1 Oscar. 11 wins & 30 nominations total,1,11,30,42
3170,Hey Arnold! The Movie,1 nomination.,0,0,1,1
3171,8 Women,11 wins & 31 nominations.,0,11,31,42
3172,8 Mile,Won 1 Oscar. Another 14 wins & 21 nominations.,1,14,21,36
3173,Irreversible,3 wins & 13 nominations.,0,3,13,16
3174,Welcome to Collinwood,2 nominations,0,0,2,2
3175,Laurel Canyon,2 wins & 6 nominations.,0,2,6,8
3176,Juwanna Mann,1 nomination.,0,0,1,1
3177,K-19: The Widowmaker,1 win & 2 nominations.,0,1,2,3
3178,XX/XY,1 nomination.,0,0,1,1
3179,Harry Potter and the Chamber of Secrets,Nominated for 3 BAFTA Film Awards. Another 13 wins & 43 nominations.,0,13,46,59
3180,Van Wilder: Party Liaison,,0,0,0,0
3181,Hart's War,1 win & 1 nomination,0,1,1,2
3182,Igby Goes Down,7 wins & 17 nominations.,0,7,17,24
3183,Heaven,6 wins & 7 nominations.,0,6,7,13
3184,Ice Age,Nominated for 1 Oscar. Another 5 wins & 29 nominations.,1,5,29,35
3185,25th Hour,Nominated for 1 Golden Globe. Another 4 wins & 16 nominations.,0,4,17,21
3186,Maid in Manhattan,1 win & 8 nominations.,0,1,8,9
3187,28 Days Later...,10 wins & 32 nominations.,0,10,32,42
3188,24 Hour Party People,1 win & 13 nominations,0,1,13,14
3189,xXx,4 wins & 14 nominations.,0,4,14,18
3190,A Walk to Remember,4 wins & 2 nominations.,0,4,2,6
3191,Kung Pow: Enter the Fist,1 win & 1 nomination,0,1,1,2
3192,Infernal Affairs,24 wins & 26 nominations.,0,24,26,50
3193,Jay and Silent Bob Strike Back,1 win & 3 nominations.,0,1,3,4
3194,Say It Isn't So,1 nomination.,0,0,1,1
3195,Blow,3 wins & 9 nominations,0,3,9,12
3196,Jason X,1 nomination,0,0,1,1
3197,El demonio,,0,0,0,0
3198,Frailty,5 wins & 16 nominations.,0,5,16,21
3199,Freddy Got Fingered,12 wins & 7 nominations,0,12,7,19
3200,Blow Dry,,0,0,0,0
3201,Crazy/Beautiful,5 nominations.,0,0,5,5
3202,The Safety of Objects,3 wins & 4 nominations.,0,3,4,7
3203,Am�lie,,0,0,0,0
3204,Juego de esp�as,,0,0,0,0
3205,Harry Potter and the Sorcerer's Stone,Nominated for 3 Oscars. Another 17 wins & 65 nominations.,3,17,65,85
3206,An American Rhapsody,5 wins & 5 nominations.,0,5,5,10
3207,See Spot Run,1 nomination.,0,0,1,1
3208,El mosquetero,,0,0,0,0
3209,Saving Silverman,,0,0,0,0
3210,Bandits,4 wins & 7 nominations,0,4,7,11
3211,Swordfish,5 wins & 10 nominations.,0,5,10,15
3212,Get Over It,4 nominations.,0,0,4,4
3213,Formula 51,1 nomination.,0,0,1,1
3214,Not Another Teen Movie,5 nominations.,0,0,5,5
3215,Domestic Disturbance,1 win & 3 nominations.,0,1,3,4
3216,Serendipity,3 nominations.,0,0,3,3
3217,Sweet November,3 nominations.,0,0,3,3
3218,The Last Castle,1 win & 4 nominations.,0,1,4,5
3219,I Am Sam,Nominated for 1 Oscar. 8 wins & 12 nominations total,1,8,12,21
3220,Mulholland Drive,,0,0,0,0
3221,Joe Dirt,1 win & 3 nominations,0,1,3,4
3222,The Believer,6 wins & 10 nominations.,0,6,10,16
3223,Training Day,Won 1 Oscar. 18 wins & 23 nominations total,1,18,23,42
3224,The Princess Diaries,3 wins & 11 nominations.,0,3,11,14
3225,Wet Hot American Summer,1 nomination.,0,0,1,1
3226,From Hell,15 nominations.,0,0,15,15
3227,Lara Croft: Tomb Raider,4 wins & 21 nominations.,0,4,21,25
3228,3000 Miles to Graceland,13 nominations.,0,0,13,13
3229,Made,1 nomination.,0,0,1,1
3230,The Affair of the Necklace,Nominated for 1 Oscar. Another 1 win & 1 nomination.,1,1,1,3
3231,Along Came a Spider,1 win & 1 nomination.,0,1,1,2
3232,American Outlaws,7 nominations,0,0,7,7
3233,Cocodrilo Dundee en Hollywood,,0,0,0,0
3234,Jimmy Neutron: Boy Genius,Nominated for 1 Oscar. Another 5 nominations.,1,0,5,6
3235,America's Sweethearts,1 win & 2 nominations.,0,1,2,3
3236,American Pie 2,8 wins & 6 nominations,0,8,6,14
3237,Joe Somebody,1 nomination,0,0,1,1
3238,The Anniversary Party,2 wins & 6 nominations.,0,2,6,8
3239,The Animal,6 nominations.,0,0,6,6
3240,Hardball,2 nominations.,0,0,2,2
3241,The Score,1 win & 1 nomination.,0,1,1,2
3242,Hannibal,9 wins & 25 nominations,0,9,25,34
3243,Jurassic Park III,5 wins & 16 nominations.,0,5,16,21
3244,The Pledge,1 win & 6 nominations.,0,1,6,7
3245,Don't Say a Word,1 nomination.,0,0,1,1
3246,Joy Ride,5 nominations.,0,0,5,5
3247,Tomcats,2 nominations,0,0,2,2
3248,Scary Movie 2,3 wins & 5 nominations.,0,3,5,8
3249,Y Tu Mam� Tambi�n,,0,0,0,0
3250,Corky Romano,1 nomination.,0,0,1,1
3251,Josie and the Pussycats,5 nominations.,0,0,5,5
3252,Donnie Darko,12 wins & 16 nominations.,0,12,16,28
3253,Amor en rojo,,0,0,0,0
3254,Riding in Cars with Boys,2 wins & 2 nominations.,0,2,2,4
3255,Lagaan: Once Upon a Time in India,Nominated for 1 Oscar. Another 54 wins & 19 nominations.,1,54,19,74
3256,Secret Ballot,10 wins & 5 nominations.,0,10,5,15
3257,Texas Rangers,,0,0,0,0
3258,Tortilla Soup,2 wins & 7 nominations.,0,2,7,9
3259,Town & Country,2 wins & 1 nomination.,0,2,1,3
3260,Dog Days,7 wins & 3 nominations.,0,7,3,10
3261,O,1 win & 1 nomination.,0,1,1,2
3262,A Beautiful Mind,Won 4 Oscars. Another 33 wins & 69 nominations.,4,33,69,106
3263,The Mexican,3 wins & 2 nominations.,0,3,2,5
3264,Kissing Jessica Stein,8 wins & 3 nominations.,0,8,3,11
3265,Soul Survivors,,0,0,0,0
3266,Hearts in Atlantis,2 wins & 8 nominations.,0,2,8,10
3267,The Other Side of Heaven,1 win.,0,1,0,1
3268,Kiss of the Dragon,2 nominations,0,0,2,2
3269,Heartbreakers,4 nominations.,0,0,4,4
3270,Kingdom Come,1 win & 6 nominations.,0,1,6,7
3271,Enigma,3 wins & 6 nominations.,0,3,6,9
3272,Enemy at the Gates,7 nominations.,0,0,7,7
3273,Dil Chahta Hai,27 wins & 37 nominations,0,27,37,64
3274,Spirited Away,Won 1 Oscar. Another 57 wins & 31 nominations.,1,57,31,89
3275,Baby Boy,1 win & 14 nominations.,0,1,14,15
3276,The Wash,,0,0,0,0
3277,The Son's Room,16 wins & 28 nominations.,0,16,28,44
3278,How High,,0,0,0,0
3279,Pearl Harbor,Won 1 Oscar. Another 13 wins & 51 nominations.,1,13,51,65
3280,Fat Girl,,0,0,0,0
3281,Planet of the Apes,Nominated for 2 BAFTA Film Awards. Another 11 wins & 30 nominations.,0,11,32,43
3282,Son of the Bride,Nominated for 1 Oscar. Another 35 wins & 11 nominations.,1,35,11,47
3283,Shrek,Won 1 Oscar. Another 39 wins & 60 nominations.,1,39,60,100
3284,The Mummy Returns,6 wins & 19 nominations,0,6,19,25
3285,Wasabi,,0,0,0,0
3286,Estrenando Cuerpo,,0,0,0,0
3287,The Tailor of Panama,1 win & 1 nomination,0,1,1,2
3288,Little Secrets,2 wins & 2 nominations.,0,2,2,4
3289,Atlantis: The Lost Empire,2 wins & 14 nominations.,0,2,14,16
3290,Hedwig and the Angry Inch,Nominated for 1 Golden Globe. Another 28 wins & 32 nominations.,0,28,33,61
3291,Atanarjuat: The Fast Runner,26 wins & 18 nominations.,0,26,18,44
3292,L.I.E.,20 wins & 18 nominations.,0,20,18,38
3293,Someone Like You...,,0,0,0,0
3294,Heist,,0,0,0,0
3295,Evolution,2 nominations.,0,0,2,2
3296,La Ci�naga,,0,0,0,0
3297,Pootie Tang,1 nomination.,0,0,1,1
3298,Exit Wounds,4 nominations,0,0,4,4
3299,Knockaround Guys,2 nominations.,0,0,2,2
3300,The One,4 nominations,0,0,4,4
3301,Ashoka the Great,,0,0,0,0
3302,Spy Kids,2 wins & 10 nominations.,0,2,10,12
3303,The Wedding Planner,2 wins & 6 nominations.,0,2,6,8
3304,Ocean's Eleven,4 wins & 20 nominations.,0,4,20,24
3305,Waking Life,5 wins & 21 nominations,0,5,21,26
3306,Life as a House,Nominated for 1 Golden Globe. Another 2 wins & 8 nominations.,0,2,9,11
3307,Birthday Girl,1 win.,0,1,0,1
3308,Kabhi Khushi Kabhie Gham...,27 wins & 43 nominations.,0,27,43,70
3309,K-PAX,3 nominations.,0,0,3,3
3310,Thir13en Ghosts,1 win & 4 nominations,0,1,4,5
3311,Angel Eyes,3 wins & 5 nominations,0,3,5,8
3312,Thirteen Conversations About One Thing,8 wins & 7 nominations.,0,8,7,15
3313,One Night at McCool's,,0,0,0,0
3314,Just Visiting,,0,0,0,0
3315,The Piano Teacher,Nominated for 1 BAFTA Film Award. Another 18 wins & 22 nominations.,0,18,23,41
3316,Sugar & Spice,2 wins & 7 nominations.,0,2,7,9
3317,Summer Catch,1 nomination.,0,0,1,1
3318,On the Line,4 nominations.,0,0,4,4
3319,Lovely & Amazing,1 nomination.,0,0,1,1
3320,Black Hawk Down,Won 2 Oscars. Another 9 wins & 37 nominations.,2,9,37,48
3321,Crush,,0,0,0,0
3322,Session 9,2 wins & 3 nominations.,0,2,3,5
3323,Super Troopers,1 win.,0,1,0,1
3324,Black Knight,2 nominations.,0,0,2,2
3325,Human Nature,2 wins & 2 nominations,0,2,2,4
3326,Original Sin,2 nominations.,0,0,2,2
3327,Sex and Lucia,,0,0,0,0
3328,Final Fantasy: The Spirits Within,3 wins & 11 nominations,0,3,11,14
3329,The Man Who Wasn't There,Nominated for 1 Oscar. Another 25 wins & 42 nominations.,1,25,42,68
3330,En alg�n lugar de �frica,,0,0,0,0
3331,Shaolin Soccer,,0,0,0,0
3332,Parejas en conflicto,,0,0,0,0
3333,The Majestic,3 wins & 1 nomination.,0,3,1,4
3334,Rat Race,3 nominations.,0,0,3,3
3335,Shallow Hal,3 nominations,0,0,3,3
3336,Antitrust,2 wins & 4 nominations,0,2,4,6
3337,Lost and Delirious,4 wins & 6 nominations.,0,4,6,10
3338,Osmosis Jones,1 win & 8 nominations.,0,1,8,9
3339,Read My Lips,7 wins & 12 nominations.,0,7,12,19
3340,Kate & Leopold,Nominated for 1 Oscar. 1 win & 5 nominations total,1,1,5,7
3341,Head Over Heels,,0,0,0,0
3342,The Shipping News,Nominated for 2 BAFTA Film Awards. Another 2 wins & 11 nominations.,0,2,13,15
3343,Recess: School's Out,,0,0,0,0
3344,The Lord of the Rings: The Fellowship of the Ring,Won 4 Oscars. Another 117 wins & 126 nominations.,4,117,126,247
3345,Storytelling,1 nomination.,0,0,1,1
3346,Dr. Dolittle 2,3 wins & 6 nominations.,0,3,6,9
3347,Tape,1 win & 1 nomination,0,1,1,2
3348,Mean Machine,,0,0,0,0
3349,The Curse of the Jade Scorpion,1 win & 1 nomination.,0,1,1,2
3350,Ghosts of Mars,2 nominations,0,0,2,2
3351,"Monsters, Inc.",Won 1 Oscar. 15 wins & 38 nominations total,1,15,38,54
3352,The Royal Tenenbaums,Nominated for 1 Oscar. Another 11 wins & 45 nominations.,1,11,45,57
3353,A.I. Artificial Intelligence,Nominated for 2 Oscars. Another 17 wins & 69 nominations.,2,17,69,88
3354,The Cat's Meow,1 win & 1 nomination.,0,1,1,2
3355,Ali,Nominated for 2 Oscars. 10 wins & 27 nominations total,2,10,27,39
3356,A Knight's Tale,4 wins & 13 nominations.,0,4,13,17
3357,Millennium Actress,6 wins & 8 nominations.,0,6,8,14
3358,Manic,1 nomination.,0,0,1,1
3359,Save the Last Dance,6 wins & 8 nominations.,0,6,8,14
3360,Valentine,2 wins & 2 nominations.,0,2,2,4
3361,Buffalo Soldiers,1 win & 6 nominations,0,1,6,7
3362,The Experiment,14 wins & 14 nominations.,0,14,14,28
3363,The Devil's Backbone,,0,0,0,0
3364,In the Bedroom,Nominated for 5 Oscars. Another 39 wins & 70 nominations.,5,39,70,114
3365,Vanilla Sky,Nominated for 1 Oscar. Another 5 wins & 33 nominations.,1,5,33,39
3366,Rush Hour 2,10 wins & 22 nominations.,0,10,22,32
3367,The Caveman's Valentine,4 nominations.,0,0,4,4
3368,Intimidad,2 wins.,0,2,0,2
3369,Max Keeble's Big Move,1 win & 1 nomination.,0,1,1,2
3370,Me Without You,2 nominations.,0,0,2,2
3371,Impostor,1 nomination.,0,0,1,1
3372,Captain Corelli's Mandolin,2 wins & 5 nominations.,0,2,5,7
3373,Two Can Play That Game,7 nominations.,0,0,7,7
3374,Sangre can�bal,,0,0,0,0
3375,Charlotte Gray,6 nominations.,0,0,6,6
3376,Glitter,3 wins & 10 nominations,0,3,10,13
3377,Rock Star,1 nomination,0,0,1,1
3378,The Forsaken,,0,0,0,0
3379,15 Minutes,1 nomination.,0,0,1,1
3380,Bully,3 wins & 1 nomination,0,3,1,4
3381,The Center of the World,1 nomination.,0,0,1,1
3382,Legally Blonde,Nominated for 2 Golden Globes. Another 6 wins & 12 nominations.,0,6,14,20
3383,Monkeybone,3 nominations.,0,0,3,3
3384,Monsoon Wedding,Nominated for 1 Golden Globe. Another 7 wins & 11 nominations.,0,7,12,19
3385,Monster's Ball,Won 1 Oscar. Another 14 wins & 23 nominations.,1,14,23,38
3386,Bubble Boy,1 nomination.,0,0,1,1
3387,Intacto,12 wins & 9 nominations.,0,12,9,21
3388,Iris,Won 1 Oscar. Another 13 wins & 31 nominations.,1,13,31,45
3389,Ghost World,Nominated for 1 Oscar. Another 28 wins & 55 nominations.,1,28,55,84
3390,The Glass House,3 nominations,0,0,3,3
3391,Brotherhood of the Wolf,4 wins & 22 nominations.,0,4,22,26
3392,Zoolander,1 win & 11 nominations,0,1,11,12
3393,The Deep End,Nominated for 1 Golden Globe. Another 4 wins & 18 nominations.,0,4,19,23
3394,The Brothers,1 win & 8 nominations.,0,1,8,9
3395,What's the Worst That Could Happen?,,0,0,0,0
3396,Gosford Park,Won 1 Oscar. Another 35 wins & 74 nominations.,1,35,74,110
3397,The Fast and the Furious,11 wins & 18 nominations.,0,11,18,29
3398,CQ,1 nomination.,0,0,1,1
3399,The Grey Zone,1 win & 3 nominations,0,1,3,4
3400,Mostly Martha,14 wins & 7 nominations.,0,14,7,21
3401,Bridget Jones's Diary,Nominated for 1 Oscar. 8 wins & 32 nominations total,1,8,32,41
3402,Driven,1 win & 10 nominations.,0,1,10,11
3403,Bride of the Wind,,0,0,0,0
3404,Cats & Dogs,11 wins & 7 nominations.,0,11,7,18
3405,Nurse Betty,5 wins & 14 nominations,0,5,14,19
3406,I Dreamed of Africa,3 nominations.,0,0,3,3
3407,Reindeer Games,3 nominations.,0,0,3,3
3408,O Fantasma,2 wins & 2 nominations.,0,2,2,4
3409,Dungeons & Dragons,11 nominations.,0,0,11,11
3410,"O Brother, Where Art Thou?",Nominated for 2 Oscars. 7 wins & 39 nominations total,2,7,39,48
3411,The Specials,,0,0,0,0
3412,Vampire Hunter D: Bloodlust,,0,0,0,0
3413,Gun Shy,,0,0,0,0
3414,Digimon: The Movie,1 win.,0,1,0,1
3415,Wonder Boys,Won 1 Oscar. 21 wins & 46 nominations total,1,21,46,68
3416,Keeping the Faith,2 wins & 6 nominations.,0,2,6,8
3417,Battlefield Earth,19 wins & 3 nominations.,0,19,3,22
3418,High Fidelity,3 wins & 22 nominations total,0,3,22,25
3419,Nutty Professor II: The Klumps,2 wins & 15 nominations.,0,2,15,17
3420,The Replacements,,0,0,0,0
3421,X-Men,13 wins & 26 nominations.,0,13,26,39
3422,What Planet Are You From?,1 nomination,0,0,1,1
3423,Remember the Titans,8 wins & 18 nominations.,0,8,18,26
3424,Miss Congeniality,Nominated for 2 Golden Globes. Another 7 wins & 6 nominations.,0,7,8,15
3425,About Adam,3 nominations.,0,0,3,3
3426,Meet the Parents,Nominated for 1 Oscar. Another 7 wins & 14 nominations.,1,7,14,22
3427,Love & Basketball,2 wins & 1 nomination.,0,2,1,3
3428,Big Momma's House,1 win & 9 nominations.,0,1,9,10
3429,Bless the Child,1 win & 6 nominations,0,1,6,7
3430,Tigerland,2 wins & 5 nominations.,0,2,5,7
3431,The Ladies Man,1 nomination.,0,0,1,1
3432,Gossip,3 nominations,0,0,3,3
3433,Woman on Top,3 nominations.,0,0,3,3
3434,Lost Souls,2 nominations.,0,0,2,2
3435,Coyote Ugly,4 wins & 8 nominations.,0,4,8,12
3436,Antes que anochezca,,0,0,0,0
3437,Nine Queens,,0,0,0,0
3438,Dracula 2000,2 nominations.,0,0,2,2
3439,Space Cowboys,Nominated for 1 Oscar. Another 4 wins & 8 nominations.,1,4,8,13
3440,The Isle,8 wins & 3 nominations.,0,8,3,11
3441,Panic,2 nominations.,0,0,2,2
3442,Finding Forrester,5 wins & 13 nominations.,0,5,13,18
3443,In the Mood for Love,Nominated for 1 BAFTA Film Award. Another 46 wins & 50 nominations.,0,46,51,97
3444,Quills,Nominated for 3 Oscars. Another 18 wins & 42 nominations.,3,18,42,63
3445,U-571: La batalla del Atl�ntico,,0,0,0,0
3446,Hollow Man,Nominated for 1 Oscar. Another 7 wins & 13 nominations.,1,7,13,21
3447,Tadpole,3 wins & 4 nominations.,0,3,4,7
3448,Titan A.E.,1 win & 6 nominations,0,1,6,7
3449,Mission: Impossible II,12 wins & 20 nominations.,0,12,20,32
3450,Greedy Guts,6 wins & 8 nominations.,0,6,8,14
3451,The Kid,2 wins.,0,2,0,2
3452,Lucky Numbers,2 wins & 1 nomination.,0,2,1,3
3453,Charlie's Angels,15 wins & 33 nominations,0,15,33,48
3454,Mission to Mars,2 nominations.,0,0,2,2
3455,Timecode,2 nominations.,0,0,2,2
3456,The Contender,Nominated for 2 Oscars. Another 1 win & 20 nominations.,2,1,20,23
3457,"Dude, Where's My Car?",6 nominations.,0,0,6,6
3458,Billy Elliot,Nominated for 3 Oscars. 56 wins & 73 nominations total,3,56,73,132
3459,State and Main,7 wins & 8 nominations,0,7,8,15
3460,102 Dalmatians,Nominated for 1 Oscar. Another 1 win & 7 nominations.,1,1,7,9
3461,Shadow of the Vampire,Nominated for 2 Oscars. Another 16 wins & 27 nominations.,2,16,27,45
3462,28 Days,1 win.,0,1,0,1
3463,Men of Honor,11 nominations,0,0,11,11
3464,The Legend of Bagger Vance,2 wins & 11 nominations.,0,2,11,13
3465,The Dish,3 wins & 10 nominations,0,3,10,13
3466,Sexy Beast,Nominated for 1 Oscar. 21 wins & 21 nominations total,1,21,21,43
3467,Thirteen Days,3 wins & 8 nominations.,0,3,8,11
3468,Under the Sand,1 win & 12 nominations.,0,1,12,13
3469,The Skulls,1 nomination,0,0,1,1
3470,The Road to El Dorado,1 win & 12 nominations.,0,1,12,13
3471,How the Grinch Stole Christmas,Won 1 Oscar. Another 17 wins & 37 nominations.,1,17,37,55
3472,Center Stage,1 win.,0,1,0,1
3473,The Yards,3 wins & 2 nominations.,0,3,2,5
3474,Love's Labour's Lost,1 win & 2 nominations.,0,1,2,3
3475,The Weight of Water,1 win & 1 nomination.,0,1,1,2
3476,Whatever It Takes,3 nominations.,0,0,3,3
3477,Romeo Must Die,2 wins & 7 nominations,0,2,7,9
3478,Red Planet,1 nomination.,0,0,1,1
3479,Kaho Naa... Pyaar Hai,44 wins & 12 nominations.,0,44,12,56
3480,Cecil B. DeMented,2 nominations.,0,0,2,2
3481,The Little Vampire,1 win & 3 nominations.,0,1,3,4
3482,Dancing at the Blue Iguana,2 wins & 1 nomination.,0,2,1,3
3483,Shanghai Noon,1 win & 7 nominations.,0,1,7,8
3484,The Whole Nine Yards,6 nominations,0,0,6,6
3485,The Man Who Cried,3 wins & 3 nominations.,0,3,3,6
3486,Rape Me,,0,0,0,0
3487,Pay It Forward,1 win & 4 nominations,0,1,4,5
3488,"Love, Honor and Obey",,0,0,0,0
3489,Supernova,,0,0,0,0
3490,Vulgar,,0,0,0,0
3491,Unbreakable,2 wins & 15 nominations,0,2,15,17
3492,Ready to Rumble,1 nomination.,0,0,1,1
3493,Fiza,7 wins & 17 nominations.,0,7,17,24
3494,What Women Want,Nominated for 1 Golden Globe. Another 5 wins & 8 nominations.,0,5,9,14
3495,Cast Away,Nominated for 2 Oscars. Another 15 wins & 36 nominations.,2,15,36,53
3496,"Crouching Tiger, Hidden Dragon",Won 4 Oscars. Another 98 wins & 134 nominations.,4,98,134,236
3497,Dinosaur,4 wins & 21 nominations.,0,4,21,25
3498,Bedazzled,1 win & 3 nominations,0,1,3,4
3499,Love & Sex,2 wins & 1 nomination.,0,2,1,3
3500,The Watcher,2 nominations.,0,0,2,2
3501,Waking the Dead,1 nomination.,0,0,1,1
3502,Shaft,2 wins & 13 nominations.,0,2,13,15
3503,Feroz,1 win.,0,1,0,1
3504,The Way of the Gun,,0,0,0,0
3505,The Crew,1 win.,0,1,0,1
3506,Animal Factory,1 nomination.,0,0,1,1
3507,The Patriot,Nominated for 3 Oscars. 9 wins & 20 nominations total,3,9,20,32
3508,The Crimson Rivers,1 win & 6 nominations.,0,1,6,7
3509,Loser,1 nomination.,0,0,1,1
3510,Duets,1 nomination.,0,0,1,1
3511,Thomas and the Magic Railroad,2 nominations.,0,0,2,2
3512,Sunset Strip,,0,0,0,0
3513,Memento,Nominated for 2 Oscars. Another 57 wins & 57 nominations.,2,57,57,116
3514,Together,15 wins & 15 nominations.,0,15,15,30
3515,Gone in Sixty Seconds,,0,0,0,0
3516,The Perfect Storm,Nominated for 2 Oscars. Another 4 wins & 25 nominations.,2,4,25,31
3517,Devils on the Doorstep,,0,0,0,0
3518,The Monkey's Mask,3 wins & 4 nominations,0,3,4,7
3519,Happy Accidents,1 win & 2 nominations.,0,1,2,3
3520,The House of Mirth,Nominated for 1 BAFTA Film Award. Another 6 wins & 28 nominations.,0,6,29,35
3521,The Flintstones in Viva Rock Vegas,1 win & 11 nominations.,0,1,11,12
3522,Small Time Crooks,1 win & 4 nominations.,0,1,4,5
3523,My Dog Skip,7 wins & 4 nominations.,0,7,4,11
3524,Rugrats in Paris: The Movie,3 wins & 7 nominations,0,3,7,10
3525,Bamboozled,1 win & 10 nominations.,0,1,10,11
3526,Code Unknown,2 wins & 4 nominations.,0,2,4,6
3527,Bring It On,2 wins & 7 nominations.,0,2,7,9
3528,The Art of War,2 wins & 9 nominations.,0,2,9,11
3529,Snatch,4 wins & 7 nominations.,0,4,7,11
3530,Maybe Baby,1 nomination.,0,0,1,1
3531,Snow Day,4 nominations.,0,0,4,4
3532,Better Than Sex,1 win & 12 nominations.,0,1,12,13
3533,Gangster No. 1,1 win & 9 nominations.,0,1,9,10
3534,Erin Brockovich,Won 1 Oscar. Another 32 wins & 59 nominations.,1,32,59,92
3535,You Can Count on Me,Nominated for 2 Oscars. 30 wins & 43 nominations total,2,30,43,75
3536,Pollock,Won 1 Oscar. 3 wins & 9 nominations total,1,3,9,13
3537,Scream 3,6 wins & 5 nominations,0,6,5,11
3538,Come Undone,1 nomination.,0,0,1,1
3539,The Emperor's New Groove,Nominated for 1 Oscar. Another 7 wins & 26 nominations.,1,7,26,34
3540,Lockdown,,0,0,0,0
3541,Screwed,,0,0,0,0
3542,Traffic,Won 4 Oscars. Another 70 wins & 87 nominations.,4,70,87,161
3543,Committed,1 win & 2 nominations.,0,1,2,3
3544,The Adventures of Rocky & Bullwinkle,2 wins & 6 nominations,0,2,6,8
3545,Bootmen,9 wins & 3 nominations.,0,9,3,12
3546,American Psycho,8 wins & 13 nominations.,0,8,13,21
3547,Hey Ram,5 wins & 7 nominations.,0,5,7,12
3548,Bounce,2 wins & 2 nominations.,0,2,2,4
3549,The Cell,Nominated for 1 Oscar. Another 9 wins & 28 nominations.,1,9,28,38
3550,Proof of Life,5 nominations.,0,0,5,5
3551,All the Pretty Horses,2 wins & 14 nominations.,0,2,14,16
3552,Little Nicky,1 win & 12 nominations,0,1,12,13
3553,Road Trip,4 wins & 9 nominations.,0,4,9,13
3554,Hanging Up,2 wins & 1 nomination,0,2,1,3
3555,Get Carter,7 nominations.,0,0,7,7
3556,The Family Man,4 wins & 6 nominations.,0,4,6,10
3557,The Broken Hearts Club: A Romantic Comedy,1 win & 1 nomination.,0,1,1,2
3558,Drowning Mona,1 nomination.,0,0,1,1
3559,Almost Famous,Won 1 Oscar. Another 52 wins & 103 nominations.,1,52,103,156
3560,Beautiful,1 win.,0,1,0,1
3561,Bread and Tulips,32 wins & 13 nominations.,0,32,13,45
3562,Autumn in New York,3 nominations,0,0,3,3
3563,Highlander: Endgame,1 nomination,0,0,1,1
3564,Down to You,1 win & 4 nominations.,0,1,4,5
3565,The Tigger Movie,4 nominations.,0,0,4,4
3566,George Washington,9 wins & 15 nominations,0,9,15,24
3567,Rules of Engagement,1 win & 2 nominations.,0,1,2,3
3568,Ed Gein,4 wins & 2 nominations.,0,4,2,6
3569,The Next Best Thing,3 wins & 10 nominations.,0,3,10,13
3570,Water Drops on Burning Rocks,3 wins & 2 nominations.,0,3,2,5
3571,Boys and Girls,1 nomination.,0,0,1,1
3572,Vatel,Nominated for 1 Oscar. Another 2 wins & 2 nominations.,1,2,2,5
3573,Psycho Beach Party,3 wins & 1 nomination.,0,3,1,4
3574,Scary Movie,7 wins & 6 nominations.,0,7,6,13
3575,Chopper,12 wins & 14 nominations.,0,12,14,26
3576,The Beach,7 nominations.,0,0,7,7
3577,Mal�na,,0,0,0,0
3578,Best in Show,Nominated for 1 Golden Globe. Another 11 wins & 13 nominations.,0,11,14,25
3579,Book of Shadows: Blair Witch 2,5 wins & 11 nominations.,0,5,11,16
3580,Final Destination,3 wins & 5 nominations,0,3,5,8
3581,Dr. T & the Women,4 nominations.,0,0,4,4
3582,Amores Perros,Nominated for 1 Oscar. 55 wins & 25 nominations total,1,55,25,81
3583,Pitch Black,2 wins & 9 nominations,0,2,9,11
3584,The Million Dollar Hotel,2 wins & 5 nominations.,0,2,5,7
3585,Leyenda urbana 2,,0,0,0,0
3586,MVP: Most Valuable Primate,1 win & 2 nominations.,0,1,2,3
3587,The Claim,1 win & 10 nominations.,0,1,10,11
3588,Sordid Lives,10 wins.,0,10,0,10
3589,Next Friday,2 nominations.,0,0,2,2
3590,Frequency,Nominated for 1 Golden Globe. Another 2 wins & 7 nominations.,0,2,8,10
3591,Restless,1 nomination.,0,0,1,1
3592,Greenfingers,1 nomination,0,0,1,1
3593,El asalto,,0,0,0,0
3594,Songcatcher,5 wins & 5 nominations.,0,5,5,10
3595,Bailando en la oscuridad,,0,0,0,0
3596,Chicken Run,Nominated for 1 BAFTA Film Award. Another 23 wins & 25 nominations.,0,23,26,49
3597,Bait,,0,0,0,0
3598,Girlfight,15 wins & 18 nominations,0,15,18,33
3599,Italiano para principiantes,,0,0,0,0
3600,Songs from the Second Floor,9 wins & 5 nominations.,0,9,5,14
3601,Requiem for a Dream,Nominated for 1 Oscar. Another 38 wins & 69 nominations.,1,38,69,108
3602,Return to Me,2 wins & 2 nominations.,0,2,2,4
3603,Here on Earth,2 nominations.,0,0,2,2
3604,The 6th Day,8 nominations,0,0,8,8
3605,Taxi 2 - Alta tensi�n,,0,0,0,0
3606,Pok�mon 3: The Movie,,0,0,0,0
3607,"Me, Myself & Irene",2 wins & 4 nominations,0,2,4,6
3608,What Lies Beneath,7 wins & 7 nominations.,0,7,7,14
3609,Vertical Limit,Nominated for 1 BAFTA Film Award. Another 2 wins & 3 nominations.,0,2,4,6
3610,Brother,1 win & 2 nominations.,0,1,2,3
3611,Werckmeister Harmonies,6 wins & 2 nominations.,0,6,2,8
3612,Boiler Room,1 win & 9 nominations.,0,1,9,10
3613,Yi Yi,15 wins & 25 nominations.,0,15,25,40
3614,The Thomas Crown Affair,3 wins & 2 nominations.,0,3,2,5
3615,Best Laid Plans,1 win.,0,1,0,1
3616,The Talented Mr. Ripley,Nominated for 5 Oscars. Another 10 wins & 76 nominations.,5,10,76,91
3617,House on Haunted Hill,1 win & 4 nominations,0,1,4,5
3618,At First Sight,,0,0,0,0
3619,The Messenger: The Story of Joan of Arc,5 wins & 13 nominations.,0,5,13,18
3620,Simpatico,1 nomination.,0,0,1,1
3621,Austin Powers: The Spy Who Shagged Me,Nominated for 1 Oscar. Another 18 wins & 30 nominations.,1,18,30,49
3622,Mansfield Park,5 nominations,0,0,5,5
3623,Simplemente irresistible,,0,0,0,0
3624,Big Daddy,8 wins & 14 nominations.,0,8,14,22
3625,Fight Club,Nominated for 1 Oscar. 11 wins & 38 nominations total,1,11,38,50
3626,Fantasia 2000,4 wins & 7 nominations.,0,4,7,11
3627,Runaway Bride,6 wins & 10 nominations.,0,6,10,16
3628,The Winslow Boy,6 wins & 5 nominations.,0,6,5,11
3629,The General's Daughter,3 wins & 5 nominations,0,3,5,8
3630,A Room for Romeo Brass,3 nominations.,0,0,3,3
3631,Eyes Wide Shut,12 wins & 30 nominations.,0,12,30,42
3632,Eye of the Beholder,1 win.,0,1,0,1
3633,The Other Sister,2 nominations.,0,0,2,2
3634,The Out-of-Towners,1 win.,0,1,0,1
3635,Star Wars: Episode I - The Phantom Menace,Nominated for 3 Oscars. Another 26 wins & 66 nominations.,3,26,66,95
3636,Better Than Chocolate,1 win & 1 nomination.,0,1,1,2
3637,Kikujiro,4 wins & 4 nominations.,0,4,4,8
3638,The Wind Will Carry Us,4 wins & 7 nominations.,0,4,7,11
3639,Universal Soldier: The Return,,0,0,0,0
3640,10 Things I Hate About You,2 wins & 13 nominations.,0,2,13,15
3641,Detroit Rock City,3 nominations.,0,0,3,3
3642,Agnes Browne,1 win & 2 nominations.,0,1,2,3
3643,"South Park: Bigger, Longer & Uncut",Nominated for 1 Oscar. Another 7 wins & 10 nominations.,1,7,10,18
3644,Pok�mon: The Movie 2000,,0,0,0,0
3645,Any Given Sunday,3 wins & 9 nominations.,0,3,9,12
3646,Enredos de oficina,,0,0,0,0
3647,Entrapment,4 wins & 6 nominations.,0,4,6,10
3648,The Matrix,Won 4 Oscars. 42 wins & 51 nominations total,4,42,51,97
3649,Arlington Road,5 nominations.,0,0,5,5
3650,The Omega Code,,0,0,0,0
3651,Payback,2 wins & 2 nominations.,0,2,2,4
3652,Marcel Proust's Time Regained,2 wins & 3 nominations.,0,2,3,5
3653,The End of the Affair,Nominated for 2 Oscars. 2 wins & 29 nominations total,2,2,29,33
3654,Snow Falling on Cedars,Nominated for 1 Oscar. Another 5 wins & 10 nominations.,1,5,10,16
3655,Plunkett & Macleane,,0,0,0,0
3656,The Minus Man,1 win & 4 nominations.,0,1,4,5
3657,But I'm a Cheerleader,2 wins & 2 nominations.,0,2,2,4
3658,Wing Commander,,0,0,0,0
3659,The Mod Squad,7 nominations,0,0,7,7
3660,Deep Blue Sea,2 wins & 4 nominations.,0,2,4,6
3661,Grey Owl,1 win & 5 nominations,0,1,5,6
3662,Whiteboyz,2 nominations.,0,0,2,2
3663,Baby Geniuses,2 wins & 3 nominations.,0,2,3,5
3664,Dick,4 nominations.,0,0,4,4
3665,Wild Wild West,15 wins & 17 nominations.,0,15,17,32
3666,The War Zone,9 wins & 12 nominations.,0,9,12,21
3667,Pushing Tin,2 nominations,0,0,2,2
3668,Pola X,2 wins & 2 nominations,0,2,2,4
3669,The Story of Us,1 win & 4 nominations.,0,1,4,5
3670,Dead or Alive,2 wins.,0,2,0,2
3671,Sleepy Hollow,Won 1 Oscar. 28 wins & 44 nominations total,1,28,44,73
3672,The Straight Story,Nominated for 1 Oscar. Another 18 wins & 39 nominations.,1,18,39,58
3673,Deuce Bigalow: Male Gigolo,2 nominations.,0,0,2,2
3674,The Muse,Nominated for 1 Golden Globe. Another 2 nominations.,0,0,3,3
3675,Inspector Gadget,1 win & 13 nominations.,0,1,13,14
3676,Instinct,1 win & 2 nominations.,0,1,2,3
3677,Splendor,,0,0,0,0
3678,La maldici�n,,0,0,0,0
3679,Random Hearts,,0,0,0,0
3680,Aimee & Jaguar,,0,0,0,0
3681,Play It to the Bone,,0,0,0,0
3682,The Sixth Sense,Nominated for 6 Oscars. Another 37 wins & 50 nominations.,6,37,50,93
3683,She's All That,8 wins & 5 nominations.,0,8,5,13
3684,Bicentennial Man,Nominated for 1 Oscar. 2 wins & 8 nominations total,1,2,8,11
3685,Asterix and Obelix vs. Caesar,4 wins & 1 nomination.,0,4,1,5
3686,End of Days,1 win & 7 nominations,0,1,7,8
3687,Anywhere But Here,4 nominations.,0,0,4,4
3688,The Virgin Suicides,3 wins & 14 nominations.,0,3,14,17
3689,Rosetta,9 wins & 7 nominations.,0,9,7,16
3690,Drop Dead Gorgeous,2 wins & 2 nominations.,0,2,2,4
3691,A Midsummer Night's Dream,1 win & 2 nominations.,0,1,2,3
3692,The Mummy,Nominated for 1 Oscar. Another 5 wins & 23 nominations.,1,5,23,29
3693,Being John Malkovich,Nominated for 3 Oscars. Another 48 wins & 76 nominations.,3,48,76,127
3694,eXistenZ: Mundo virtual,,0,0,0,0
3695,Election,Nominated for 1 Oscar. 16 wins & 34 nominations total,1,16,34,51
3696,Ratcatcher,12 wins & 6 nominations.,0,12,6,18
3697,Tea with Mussolini,Won 1 BAFTA Film Award. Another 4 wins & 3 nominations.,0,5,3,8
3698,True Crime,5 nominations.,0,0,5,5
3699,Message in a Bottle,6 nominations,0,0,6,6
3700,Tarzan,Won 1 Oscar. Another 10 wins & 23 nominations.,1,10,23,34
3701,Molly,,0,0,0,0
3702,Rescate explosivo,,0,0,0,0
3703,Blue Streak,,0,0,0,0
3704,Teaching Mrs. Tingle,4 nominations.,0,0,4,4
3705,Bowfinger,6 nominations.,0,0,6,6
3706,Magnolia,Nominated for 3 Oscars. 28 wins & 59 nominations total,3,28,59,90
3707,The Insider,Nominated for 7 Oscars. Another 23 wins & 51 nominations.,7,23,51,81
3708,The Cider House Rules,Won 2 Oscars. Another 6 wins & 30 nominations.,2,6,30,38
3709,Liberty Heights,2 nominations.,0,0,2,2
3710,Terror Firmer,,0,0,0,0
3711,Cookie's Fortune,3 wins & 11 nominations.,0,3,11,14
3712,Man on the Moon,Won 1 Golden Globe. Another 4 wins & 25 nominations.,0,5,25,30
3713,The Color of Paradise,10 wins & 11 nominations.,0,10,11,21
3714,The Bachelor,1 win & 2 nominations.,0,1,2,3
3715,Life,8 nominations,0,0,8,8
3716,Virus,,0,0,0,0
3717,Forces of Nature,2 wins & 5 nominations.,0,2,5,7
3718,In Dreams,1 win.,0,1,0,1
3719,The King and I,Won 5 Oscars. Another 5 wins & 12 nominations.,5,5,12,22
3720,Mumford,1 win & 1 nomination,0,1,1,2
3721,Go,5 wins & 7 nominations.,0,5,7,12
3722,Gloria,Nominated for 1 Oscar. Another 4 wins & 4 nominations.,1,4,4,9
3723,Beau Travail,6 wins & 11 nominations.,0,6,11,17
3724,Titus,Nominated for 1 Oscar. Another 4 wins & 18 nominations.,1,4,18,23
3725,Crazy in Alabama,5 wins & 6 nominations.,0,5,6,11
3726,Virtual Sexuality,,0,0,0,0
3727,The Iron Giant,20 wins & 18 nominations total,0,20,18,38
3728,Cradle Will Rock,5 wins & 7 nominations.,0,5,7,12
3729,Muppets from Space,1 nomination.,0,0,1,1
3730,Music of the Heart,Nominated for 2 Oscars. Another 5 wins & 9 nominations.,2,5,9,16
3731,Never Been Kissed,2 wins & 8 nominations.,0,2,8,10
3732,Julien Donkey-Boy,3 wins & 4 nominations.,0,3,4,7
3733,Trippin',,0,0,0,0
3734,"Happy, Texas",6 wins & 6 nominations.,0,6,6,12
3735,The Astronaut's Wife,1 nomination.,0,0,1,1
3736,Ghost dog - El camino del samurai,,0,0,0,0
3737,American Beauty,Won 5 Oscars. Another 106 wins & 102 nominations.,5,106,102,213
3738,A Walk on the Moon,1 win & 6 nominations.,0,1,6,7
3739,East Is East,Nominated for 4 BAFTA Film Awards. Another 16 wins & 10 nominations.,0,16,14,30
3740,Edtv,2 nominations,0,0,2,2
3741,American Pie,9 wins & 14 nominations.,0,9,14,23
3742,Double Jeopardy,1 win & 3 nominations.,0,1,3,4
3743,Galaxy Quest,7 wins & 14 nominations.,0,7,14,21
3744,My Life So Far,,0,0,0,0
3745,Jin-Roh: The Wolf Brigade,4 wins & 2 nominations.,0,4,2,6
3746,Chill Factor,1 nomination.,0,0,1,1
3747,My Favorite Martian,3 nominations.,0,0,3,3
3748,Mystery Men,3 nominations.,0,0,3,3
3749,"Mystery, Alaska",1 nomination.,0,0,1,1
3750,Brokedown Palace,1 nomination,0,0,1,1
3751,The 13th Warrior,2 wins & 2 nominations.,0,2,2,4
3752,Topsy-Turvy,Won 2 Oscars. Another 11 wins & 28 nominations.,2,11,28,41
3753,"Girl, Interrupted",Won 1 Oscar. 8 wins & 11 nominations total,1,8,11,20
3754,Bringing Out the Dead,2 wins & 5 nominations.,0,2,5,7
3755,The Green Mile,Nominated for 4 Oscars. Another 15 wins & 33 nominations.,4,15,33,52
3756,Body Shots,,0,0,0,0
3757,Lake Placid,,0,0,0,0
3758,Toy Story 2,Nominated for 1 Oscar. Another 21 wins & 26 nominations.,1,21,26,48
3759,Coming Soon,1 win & 6 nominations.,0,1,6,7
3760,Jesus' Son,4 wins & 7 nominations.,0,4,7,11
3761,Ride with the Devil,1 nomination,0,0,1,1
3762,200 Cigarettes,2 nominations.,0,0,2,2
3763,The Hurricane,Nominated for 1 Oscar. Another 7 wins & 17 nominations.,1,7,17,25
3764,All About My Mother,Won 1 Oscar. 58 wins & 40 nominations total,1,58,40,99
3765,The Adventures of Elmo in Grouchland,1 win & 1 nomination.,0,1,1,2
3766,Blast from the Past,1 nomination.,0,0,1,1
3767,Boys Don't Cry,Won 1 Oscar. 50 wins & 38 nominations total,1,50,38,89
3768,An Ideal Husband,Nominated for 2 Golden Globes. Another 4 wins & 15 nominations.,0,4,17,21
3769,The Road Home,19 wins & 10 nominations.,0,19,10,29
3770,8MM,2 wins & 2 nominations,0,2,2,4
3771,The Limey,1 win & 9 nominations.,0,1,9,10
3772,The Boondock Saints,,0,0,0,0
3773,Human Traffic,9 wins & 7 nominations.,0,9,7,16
3774,Mickey Blue Eyes,,0,0,0,0
3775,8 � Women,,0,0,0,0
3776,In Too Deep,2 wins.,0,2,0,2
3777,Black & White,56 wins & 4 nominations.,0,56,4,60
3778,The Bone Collector,1 win & 3 nominations.,0,1,3,4
3779,Dudley Do-Right,1 nomination.,0,0,1,1
3780,The Girl on the Bridge,Nominated for 1 BAFTA Film Award. Another 6 wins & 17 nominations.,0,6,18,24
3781,Swiri,8 wins & 4 nominations.,0,8,4,12
3782,Onegin,3 wins & 4 nominations total,0,3,4,7
3783,Idle Hands,4 nominations.,0,0,4,4
3784,Angela's Ashes,Nominated for 1 Oscar. Another 5 wins & 11 nominations.,1,5,11,17
3785,A Map of the World,Nominated for 1 Golden Globe. Another 3 wins & 5 nominations.,0,3,6,9
3786,Drive Me Crazy,1 win,0,1,0,1
3787,Stir of Echoes,3 wins & 5 nominations.,0,3,5,8
3788,Stigmata,6 nominations.,0,0,6,6
3789,Outside Providence,1 nomination.,0,0,1,1
3790,Tumbleweeds,Nominated for 1 Oscar. Another 10 wins & 11 nominations.,1,10,11,22
3791,The Loss of Sexual Innocence,1 nomination.,0,0,1,1
3792,Anna and the King,Nominated for 2 Oscars. Another 12 nominations.,2,0,12,14
3793,The World Is Not Enough,7 wins & 12 nominations.,0,7,12,19
3794,The Deep End of the Ocean,3 wins & 2 nominations.,0,3,2,5
3795,The Love Letter,1 nomination.,0,0,1,1
3796,The Wood,1 win & 7 nominations.,0,1,7,8
3797,Jakob the Liar,2 wins & 3 nominations.,0,2,3,5
3798,Varsity Blues,2 wins & 5 nominations.,0,2,5,7
3799,Hum Saath-Saath Hain: We Stand United,1 win & 1 nomination.,0,1,1,2
3800,Holy Smoke,2 wins & 3 nominations.,0,2,3,5
3801,Love Stinks,,0,0,0,0
3802,Romance,1 nomination.,0,0,1,1
3803,Cruel Intentions,8 wins & 14 nominations.,0,8,14,22
3804,La �ltima puerta,,0,0,0,0
3805,Sweet and Lowdown,Nominated for 2 Oscars. Another 1 win & 13 nominations.,2,1,13,16
3806,Notting Hill,Nominated for 1 BAFTA Film Award. Another 11 wins & 16 nominations.,0,11,17,28
3807,For Love of the Game,7 nominations.,0,0,7,7
3808,El piso 13,,0,0,0,0
3809,The Corruptor,1 nomination,0,0,1,1
3810,Three to Tango,,0,0,0,0
3811,Godzilla 2000,2 nominations.,0,0,2,2
3812,Dogma,8 nominations,0,0,8,8
3813,Superstar,2 nominations.,0,0,2,2
3814,October Sky,4 wins & 11 nominations.,0,4,11,15
3815,Breakfast of Champions,1 nomination.,0,0,1,1
3816,The Rage: Carrie 2,1 win & 3 nominations.,0,1,3,4
3817,Three Kings,8 wins & 19 nominations.,0,8,19,27
3818,Summer of Sam,6 nominations.,0,0,6,6
3819,"Stuart Little, un rat�n en la familia",,0,0,0,0
3820,Bats,,0,0,0,0
3821,The Blair Witch Project,19 wins & 26 nominations.,0,19,26,45
3822,Jawbreaker,1 nomination.,0,0,1,1
3823,Humanit�,,0,0,0,0
3824,Analyze This,4 wins & 7 nominations.,0,4,7,11
3825,The Big Kahuna,1 nomination.,0,0,1,1
3826,Trick,2 wins & 2 nominations.,0,2,2,4
3827,The Best Man,8 wins & 11 nominations.,0,8,11,19
3828,Savior,2 wins.,0,2,0,2
3829,Run Lola Run,Nominated for 1 BAFTA Film Award. Another 28 wins & 20 nominations.,0,28,21,49
3830,The Object of My Affection,1 win & 1 nomination,0,1,1,2
3831,Simon Birch,3 wins & 3 nominations,0,3,3,6
3832,Ride,,0,0,0,0
3833,Saving Private Ryan,Won 5 Oscars. Another 74 wins & 75 nominations.,5,74,75,154
3834,The Odd Couple II,1 nomination.,0,0,1,1
3835,Psycho,Nominated for 4 Oscars. Another 8 wins & 10 nominations.,4,8,10,22
3836,What Dreams May Come,Won 1 Oscar. Another 6 wins & 2 nominations.,1,6,2,9
3837,Esc�ndalo,,0,0,0,0
3838,Wide Awake,2 nominations.,0,0,2,2
3839,Beloved,Nominated for 1 Oscar. 3 wins & 24 nominations total,1,3,24,28
3840,Ringmaster,1 win.,0,1,0,1
3841,Eternity and a Day,9 wins & 4 nominations.,0,9,4,13
3842,High Art,7 wins & 18 nominations.,0,7,18,25
3843,Enemy of the State,5 wins & 16 nominations.,0,5,16,21
3844,El secreto,,0,0,0,0
3845,Safe Men,,0,0,0,0
3846,The Parent Trap,2 wins & 7 nominations,0,2,7,9
3847,Rounders,1 win & 1 nomination.,0,1,1,2
3848,Doctor Dolittle,4 wins & 10 nominations.,0,4,10,14
3849,Holy Man,1 nomination.,0,0,1,1
3850,Rush Hour,6 wins & 9 nominations,0,6,9,15
3851,SLC Punk!,2 wins & 6 nominations.,0,2,6,8
3852,Homegrown,,0,0,0,0
3853,Hideous Kinky,1 win.,0,1,0,1
3854,Elizabeth,Won 1 Oscar. Another 33 wins & 55 nominations.,1,33,55,89
3855,Barney's Great Adventure,5 nominations.,0,0,5,5
3856,Ronin,1 win & 4 nominations.,0,1,4,5
3857,Dirty Work,,0,0,0,0
3858,The Siege,2 wins & 4 nominations.,0,2,4,6
3859,Shakespeare in Love,Won 7 Oscars. Another 57 wins & 87 nominations.,7,57,87,151
3860,Home Fries,,0,0,0,0
3861,The Replacement Killers,1 nomination.,0,0,1,1
3862,Senseless,,0,0,0,0
3863,The Prince of Egypt,Won 1 Oscar. 12 wins & 27 nominations total,1,12,27,40
3864,Edge of Seventeen,5 wins & 2 nominations.,0,5,2,7
3865,The Rugrats Movie,2 wins & 6 nominations.,0,2,6,8
3866,Belly,1 nomination.,0,0,1,1
3867,Lethal Weapon 4,4 wins & 11 nominations,0,4,11,15
3868,West Beirut,8 wins & 2 nominations.,0,8,2,10
3869,Return to Paradise,2 nominations.,0,0,2,2
3870,Hilary and Jackie,Nominated for 2 Oscars. Another 4 wins & 22 nominations.,2,4,22,28
3871,The Opposite of Sex,Nominated for 1 Golden Globe. Another 14 wins & 23 nominations.,0,14,24,38
3872,B. Monkey,,0,0,0,0
3873,Why Do Fools Fall in Love,2 wins & 4 nominations.,0,2,4,6
3874,Earth,5 wins & 1 nomination.,0,5,1,6
3875,BASEketball,2 nominations.,0,0,2,2
3876,Show Me Love,19 wins & 8 nominations.,0,19,8,27
3877,The Players Club,1 win.,0,1,0,1
3878,A Night at the Roxbury,,0,0,0,0
3879,Babe el puerquito va a la ciudad,,0,0,0,0
3880,Rudolph the Red-Nosed Reindeer,,0,0,0,0
3881,Rushmore,16 wins & 16 nominations,0,16,16,32
3882,Love Is the Devil: Study for a Portrait of Francis Bacon,7 wins & 3 nominations.,0,7,3,10
3883,Hope Floats,3 wins & 9 nominations.,0,3,9,12
3884,Blade,5 wins & 11 nominations.,0,5,11,16
3885,"Black Cat, White Cat",5 wins & 5 nominations,0,5,5,10
3886,The Legend of 1900,Won 1 Golden Globe. Another 21 wins & 10 nominations.,0,22,10,32
3887,He Got Game,10 nominations.,0,0,10,10
3888,Black Dog,,0,0,0,0
3889,Hurlyburly,1 win & 3 nominations.,0,1,3,4
3890,Lovers of the Arctic Circle,14 wins & 8 nominations.,0,14,8,22
3891,Hush,2 wins & 7 nominations.,0,2,7,9
3892,Following,5 wins & 4 nominations.,0,5,4,9
3893,The Last Days of Disco,1 win & 1 nomination,0,1,1,2
3894,The Red Violin,Won 1 Oscar. Another 19 wins & 19 nominations.,1,19,19,39
3895,The Land Girls,,0,0,0,0
3896,Thursday,1 win & 1 nomination.,0,1,1,2
3897,Gods and Monsters,Won 1 Oscar. Another 37 wins & 33 nominations.,1,37,33,71
3898,Halloween H20: 20 Years Later,2 wins & 12 nominations,0,2,12,14
3899,U.S. Marshals,1 nomination.,0,0,1,1
3900,54,9 nominations.,0,0,9,9
3901,Free Enterprise,5 wins & 2 nominations.,0,5,2,7
3902,One True Thing,Nominated for 1 Oscar. Another 7 nominations.,1,0,7,8
3903,Strangeland,1 nomination.,0,0,1,1
3904,Tarzan and the Lost City,1 nomination.,0,0,1,1
3905,Chairman of the Board,3 nominations.,0,0,3,3
3906,Goodbye Lover,2 nominations.,0,0,2,2
3907,Another Day in Paradise,3 wins & 1 nomination.,0,3,1,4
3908,Celebrity,4 nominations.,0,0,4,4
3909,Firestorm,,0,0,0,0
3910,Un �ngel enamorado,,0,0,0,0
3911,Ciudad en tinieblas,,0,0,0,0
3912,Woo,,0,0,0,0
3913,Central Station,Nominated for 2 Oscars. Another 43 wins & 24 nominations.,2,43,24,69
3914,The X Files,7 wins & 11 nominations.,0,7,11,18
3915,Head On,9 wins & 15 nominations.,0,9,15,24
3916,Mighty Joe Young,Nominated for 1 Oscar. 1 win & 4 nominations total,1,1,4,6
3917,Still Crazy,2 wins & 5 nominations.,0,2,5,7
3918,Buffalo '66,6 wins & 11 nominations.,0,6,11,17
3919,Out of Sight,Nominated for 2 Oscars. Another 13 wins & 13 nominations.,2,13,13,28
3920,Dangerous Beauty,2 nominations.,0,0,2,2
3921,Dancing at Lughnasa,2 wins & 7 nominations.,0,2,7,9
3922,Dance with Me,5 nominations.,0,0,5,5
3923,There's Something About Mary,Nominated for 2 Golden Globes. Another 17 wins & 15 nominations.,0,17,17,34
3924,Cousin Bette,1 win & 1 nomination.,0,1,1,2
3925,The Magic Sword: Quest for Camelot,,0,0,0,0
3926,The Horse Whisperer,Nominated for 1 Oscar. Another 4 wins & 18 nominations.,1,4,18,23
3927,Mafia!,2 nominations.,0,0,2,2
3928,All I Wanna Do,,0,0,0,0
3929,My Giant,,0,0,0,0
3930,Bride of Chucky,5 wins & 7 nominations,0,5,7,12
3931,Happiness,Nominated for 1 Golden Globe. Another 12 wins & 25 nominations.,0,12,26,38
3932,Velvet Goldmine,Nominated for 1 Oscar. Another 4 wins & 11 nominations.,1,4,11,16
3933,You've Got Mail,6 wins & 8 nominations.,0,6,8,14
3934,Get Real,6 wins & 3 nominations,0,6,3,9
3935,3 Ninjas: High Noon at Mega Mountain,2 nominations.,0,0,2,2
3936,Major League: Back to the Minors,1 win.,0,1,0,1
3937,Mulan,Nominated for 1 Oscar. Another 17 wins & 20 nominations.,1,17,20,38
3938,Almost Heroes,,0,0,0,0
3939,The Hi-Lo Country,4 wins & 4 nominations.,0,4,4,8
3940,The Big Hit,,0,0,0,0
3941,The Big Lebowski,5 wins & 18 nominations,0,5,18,23
3942,Clay Pigeons,1 nomination.,0,0,1,1
3943,Your Friends & Neighbors,2 wins & 4 nominations.,0,2,4,6
3944,My Name Is Joe,13 wins & 11 nominations.,0,13,11,24
3945,Madeline,5 nominations.,0,0,5,5
3946,Xiu Xiu: The Sent-Down Girl,12 wins & 13 nominations.,0,12,13,25
3947,I Want You,2 wins & 2 nominations.,0,2,2,4
3948,Blues Brothers 2000,4 nominations.,0,0,4,4
3949,I Stand Alone,5 wins & 6 nominations.,0,5,6,11
3950,Zero Effect,1 nomination.,0,0,1,1
3951,New Rose Hotel,2 wins & 2 nominations.,0,2,2,4
3952,I Still Know What You Did Last Summer,5 wins & 7 nominations,0,5,7,12
3953,Vampires,7 wins & 6 nominations.,0,7,6,13
3954,The Impostors,1 nomination.,0,0,1,1
3955,Immortality,3 wins & 3 nominations.,0,3,3,6
3956,I'll Be Home for Christmas,,0,0,0,0
3957,American History X,Nominated for 1 Oscar. 4 wins & 15 nominations total,1,4,15,20
3958,The Celebration,Nominated for 1 BAFTA Film Award. Another 28 wins & 22 nominations.,0,28,23,51
3959,Very Bad Things,2 wins & 3 nominations.,0,2,3,5
3960,The Acid House,6 wins & 4 nominations.,0,6,4,10
3961,Twice Upon a Yesterday,3 wins & 5 nominations.,0,3,5,8
3962,Hard Rain,,0,0,0,0
3963,Jack Frost,1 nomination.,0,0,1,1
3964,Train of Life,10 wins & 4 nominations.,0,10,4,14
3965,Without Limits,Nominated for 1 Golden Globe. Another 1 win & 1 nomination.,0,1,2,3
3966,Stepmom,8 wins & 7 nominations,0,8,7,15
3967,The General,2 wins & 1 nomination.,0,2,1,3
3968,The Thin Red Line,Nominated for 7 Oscars. 21 wins & 47 nominations total,7,21,47,75
3969,Pleasantville,Nominated for 3 Oscars. 18 wins & 45 nominations total,3,18,45,66
3970,Meet the Deedles,1 win & 2 nominations.,0,1,2,3
3971,Playing by Heart,1 win & 1 nomination.,0,1,1,2
3972,The Mighty,Nominated for 2 Golden Globes. Another 3 wins & 2 nominations.,0,3,4,7
3973,Kissing a Fool,1 nomination.,0,0,1,1
3974,Star Trek: Insurrection,3 wins & 8 nominations.,0,3,8,11
3975,Bulworth,Nominated for 1 Oscar. 1 win & 20 nominations total,1,1,20,22
3976,Fallen,3 nominations.,0,0,3,3
3977,Phantoms,2 nominations.,0,0,2,2
3978,Slappy and the Stinkers,1 win,0,1,0,1
3979,The Newton Boys,,0,0,0,0
3980,Sour Grapes,2 wins,0,2,0,2
3981,Pi,8 wins & 12 nominations.,0,8,12,20
3982,Urban Legend,1 win & 2 nominations.,0,1,2,3
3983,Little Voice,Nominated for 1 Oscar. Another 2 wins & 29 nominations.,1,2,29,32
3984,Species II,1 nomination.,0,0,1,1
3985,Ever After: A Cinderella Story,6 wins & 15 nominations.,0,6,15,21
3986,Meet Joe Black,3 wins & 6 nominations.,0,3,6,9
3987,Soldier,1 nomination.,0,0,1,1
3988,Slums of Beverly Hills,9 nominations.,0,0,9,9
3989,A Perfect Murder,2 wins & 3 nominations.,0,2,3,5
3990,Sliding Doors,6 wins & 4 nominations.,0,6,4,10
3991,Smoke Signals,12 wins & 8 nominations.,0,12,8,20
3992,A Civil Action,Nominated for 2 Oscars. Another 5 wins & 8 nominations.,2,5,8,15
3993,Snake Eyes,1 win & 4 nominations.,0,1,4,5
3994,Acusado sin raz�n,,0,0,0,0
3995,Deep Rising,2 nominations.,0,0,2,2
3996,Deep Impact,5 wins & 14 nominations.,0,5,14,19
3997,"Lock, Stock and Two Smoking Barrels",Nominated for 1 BAFTA Film Award. Another 13 wins & 8 nominations.,0,13,9,22
3998,The Truman Show,Nominated for 3 Oscars. Another 40 wins & 66 nominations.,3,40,66,109
3999,Knock Off,,0,0,0,0
4000,Krippendorf's Tribe,1 nomination.,0,0,1,1
4001,Wild Things,2 wins & 4 nominations.,0,2,4,6
4002,Pok�mon: The First Movie - Mewtwo Strikes Back,,0,0,0,0
4003,Small Soldiers,3 wins & 4 nominations,0,3,4,7
4004,Practical Magic,1 win & 6 nominations,0,1,6,7
4005,Kuch Kuch Hota Hai,28 wins & 3 nominations.,0,28,3,31
4006,Apt Pupil,6 wins & 10 nominations.,0,6,10,16
4007,Half Baked,,0,0,0,0
4008,Paulie,2 wins & 6 nominations.,0,2,6,8
4009,Six-String Samurai,2 wins & 2 nominations.,0,2,2,4
4010,Six Days Seven Nights,2 wins & 5 nominations,0,2,5,7
4011,How Stella Got Her Groove Back,4 wins & 8 nominations.,0,4,8,12
4012,The Wedding Singer,5 wins & 7 nominations.,0,5,7,12
4013,The Man in the Iron Mask,3 wins & 4 nominations.,0,3,4,7
4014,Patch Adams,Nominated for 1 Oscar. Another 1 win & 7 nominations.,1,1,7,9
4015,Fear and Loathing in Las Vegas,1 win & 3 nominations.,0,1,3,4
4016,Mercury Rising,2 wins.,0,2,0,2
4017,Waking Ned Devine,,0,0,0,0
4018,The Gingerbread Man,,0,0,0,0
4019,Los idiotas,,0,0,0,0
4020,Desperate Measures,1 win.,0,1,0,1
4021,Antz,Nominated for 1 BAFTA Film Award. Another 6 wins & 13 nominations.,0,6,14,20
4022,A Simple Plan,Nominated for 2 Oscars. Another 16 wins & 22 nominations.,2,16,22,40
4023,Pecker,2 wins & 1 nomination.,0,2,1,3
4024,Can't Hardly Wait,2 nominations.,0,0,2,2
4025,Armageddon,Nominated for 4 Oscars. Another 15 wins & 36 nominations.,4,15,36,55
4026,The Waterboy,6 wins & 6 nominations.,0,6,6,12
4027,Dead Man on Campus,,0,0,0,0
4028,The Mask of Zorro,Nominated for 2 Oscars. Another 9 wins & 16 nominations.,2,9,16,27
4029,Permanent Midnight,1 nomination.,0,0,1,1
4030,The Faculty,11 nominations.,0,0,11,11
4031,The Dinner Game,,0,0,0,0
4032,Perturbados,,0,0,0,0
4033,Air Bud: Golden Receiver,4 nominations.,0,0,4,4
4034,A Bug's Life,Nominated for 1 Oscar. Another 14 wins & 20 nominations.,1,14,20,35
4035,Sphere,3 nominations,0,0,3,3
4036,Jackie Brown,Nominated for 1 Oscar. Another 8 wins & 23 nominations.,1,8,23,32
4037,City of Industry,1 nomination.,0,0,1,1
4038,The Boxer,Nominated for 3 Golden Globes. Another 3 wins & 3 nominations.,0,3,6,9
4039,'Til There Was You,1 nomination.,0,0,1,1
4040,The End of Violence,1 win & 4 nominations.,0,1,4,5
4041,Camino sin retorno,,0,0,0,0
4042,Inventing the Abbotts,,0,0,0,0
4043,Zeus and Roxanne,,0,0,0,0
4044,The Butcher Boy,10 wins & 11 nominations.,0,10,11,21
4045,The Edge,3 nominations.,0,0,3,3
4046,In the Company of Men,14 wins & 12 nominations.,0,14,12,26
4047,The Rainmaker,2 wins & 10 nominations,0,2,10,12
4048,Cats Don't Dance,3 wins & 13 nominations.,0,3,13,16
4049,Addicted to Love,1 nomination.,0,0,1,1
4050,The Crazy Stranger,9 wins & 5 nominations.,0,9,5,14
4051,The Devil's Advocate,2 wins & 7 nominations.,0,2,7,9
4052,Buddy,6 wins & 6 nominations.,0,6,6,12
4053,The Devil's Own,1 nomination.,0,0,1,1
4054,Character,Won 1 Oscar. Another 17 wins & 7 nominations.,1,17,7,25
4055,Lawn Dogs,7 wins & 4 nominations.,0,7,4,11
4056,The Real Blonde,,0,0,0,0
4057,Bean,2 wins & 1 nomination,0,2,1,3
4058,Chasing Amy,Nominated for 1 Golden Globe. Another 5 wins & 15 nominations.,0,5,16,21
4059,The Game,1 nomination.,0,0,1,1
4060,In & Out,Won 2 Oscars. Another 135 wins & 373 nominations.,2,135,373,510
4061,The Full Monty,Won 1 Oscar. 37 wins & 35 nominations total,1,37,35,73
4062,Children of Heaven,,0,0,0,0
4063,The Castle,2 wins & 11 nominations.,0,2,11,13
4064,The Borrowers,Nominated for 1 BAFTA Film Award. Another 1 win & 3 nominations.,0,1,4,5
4065,I Know What You Did Last Summer,3 wins & 7 nominations.,0,3,7,10
4066,Breaking Up,,0,0,0,0
4067,How to Be a Player,,0,0,0,0
4068,Speed 2: Cruise Control,1 win & 9 nominations.,0,1,9,10
4069,Shooting Fish,3 wins.,0,3,0,3
4070,Spice World,3 wins & 11 nominations.,0,3,11,14
4071,The MatchMaker,,0,0,0,0
4072,The Peacemaker,2 nominations.,0,0,2,2
4073,The Manson Family,1 nomination.,0,0,1,1
4074,Wishmaster,3 nominations.,0,0,3,3
4075,Breakdown,1 win & 2 nominations.,0,1,2,3
4076,Star Kid,,0,0,0,0
4077,Star Maps,1 win & 7 nominations.,0,1,7,8
4078,The Man Who Knew Too Little,,0,0,0,0
4079,Starship Troopers,Nominated for 1 Oscar. Another 3 wins & 15 nominations.,1,3,15,19
4080,Steel,1 nomination.,0,0,1,1
4081,The Lost World: Jurassic Park,Nominated for 1 Oscar. 4 wins & 28 nominations total,1,4,28,33
4082,Digging to China,2 wins.,0,2,0,2
4083,Spawn,2 wins & 6 nominations.,0,2,6,8
4084,Beverly Hills Ninja,1 nomination.,0,0,1,1
4085,Kiss the Girls,5 nominations.,0,0,5,5
4086,Soul Food,6 wins & 11 nominations.,0,6,11,17
4087,Wilde,Nominated for 1 Golden Globe. Another 4 wins & 7 nominations.,0,4,8,12
4088,Deceiver,3 wins.,0,3,0,3
4089,Hoodlum,7 nominations,0,0,7,7
4090,Deconstructing Harry,Nominated for 1 Oscar. Another 4 wins & 5 nominations.,1,4,5,10
4091,Knockin' on Heaven's Door,8 wins & 3 nominations.,0,8,3,11
4092,Smilla's Sense of Snow,1 nomination,0,0,1,1
4093,Wild America,1 win.,0,1,0,1
4094,Kull the Conqueror,,0,0,0,0
4095,L.A. Confidential,Won 2 Oscars. Another 89 wins & 85 nominations.,2,89,85,176
4096,Kundun,Nominated for 4 Oscars. Another 7 wins & 9 nominations.,4,7,9,20
4097,Bent,3 wins & 3 nominations.,0,3,3,6
4098,The Night Flier,1 win & 2 nominations.,0,1,2,3
4099,Dante's Peak,4 wins & 1 nomination.,0,4,1,5
4100,Home Alone 3,3 nominations.,0,0,3,3
4101,Dangerous Ground,,0,0,0,0
4102,Contact,Nominated for 1 Oscar. Another 14 wins & 30 nominations.,1,14,30,45
4103,Clockwatchers,2 wins & 1 nomination.,0,2,1,3
4104,The Beautician and the Beast,1 nomination.,0,0,1,1
4105,The Assignment,,0,0,0,0
4106,The House of Yes,1 win & 6 nominations.,0,1,6,7
4107,The Apostle,Nominated for 1 Oscar. Another 13 wins & 7 nominations.,1,13,7,21
4108,Double Team,4 wins,0,4,0,4
4109,Scream 2,8 wins & 13 nominations.,0,8,13,21
4110,Booty Call,,0,0,0,0
4111,The Postman,7 wins & 7 nominations.,0,7,7,14
4112,Boogie Nights,Nominated for 3 Oscars. 36 wins & 64 nominations total,3,36,64,103
4113,The Ice Storm,Won 1 BAFTA Film Award. Another 5 wins & 33 nominations.,0,6,33,39
4114,Con Air,Nominated for 2 Oscars. Another 7 wins & 9 nominations.,2,7,9,18
4115,That Darn Cat,2 nominations.,0,0,2,2
4116,Conspiracy Theory,4 wins & 1 nomination.,0,4,1,5
4117,Donnie Brasco,Nominated for 1 Oscar. Another 2 wins & 15 nominations.,1,2,15,18
4118,Still Breathing,1 win & 1 nomination.,0,1,1,2
4119,Cop Land,1 win & 1 nomination,0,1,1,2
4120,Taste of Cherry,3 wins & 5 nominations.,0,3,5,8
4121,Selena,8 wins & 6 nominations,0,8,6,14
4122,The Jackal,1 win & 4 nominations.,0,1,4,5
4123,8 Heads in a Duffel Bag,1 win.,0,1,0,1
4124,Bliss,1 win & 1 nomination.,0,1,1,2
4125,Sin embargo es adorable,,0,0,0,0
4126,Switchback,,0,0,0,0
4127,Jungle 2 Jungle,3 nominations.,0,0,3,3
4128,The Last Time I Committed Suicide,,0,0,0,0
4129,Seven Years in Tibet,Nominated for 1 Golden Globe. Another 3 wins & 7 nominations.,0,3,8,11
4130,Suicide Kings,,0,0,0,0
4131,The Pest,1 nomination.,0,0,1,1
4132,Shadow Conspiracy,,0,0,0,0
4133,Batman & Robin,Won 1 Oscar. Another 8 wins & 26 nominations.,1,8,26,35
4134,The Fifth Element,Nominated for 1 Oscar. Another 10 wins & 38 nominations.,1,10,38,49
4135,Alien Resurrection,7 wins & 21 nominations.,0,7,21,28
4136,For Richer or Poorer,1 nomination.,0,0,1,1
4137,Going All the Way,1 win & 2 nominations.,0,1,2,3
4138,Titanic,Won 11 Oscars. Another 115 wins & 83 nominations.,11,115,83,209
4139,Princess Mononoke,,0,0,0,0
4140,Gone Fishin',1 nomination.,0,0,1,1
4141,Eight Days a Week,3 wins.,0,3,0,3
4142,Face/Off,Nominated for 1 Oscar. Another 11 wins & 21 nominations.,1,11,21,33
4143,FairyTale: A True Story,1 win & 3 nominations.,0,1,3,4
4144,An American Werewolf in Paris,3 wins & 1 nomination.,0,3,1,4
4145,Volcano,1 win & 1 nomination.,0,1,1,2
4146,Picture Perfect,,0,0,0,0
4147,Mimic,3 wins & 8 nominations.,0,3,8,11
4148,Good Burger,,0,0,0,0
4149,Private Parts,2 wins & 3 nominations.,0,2,3,5
4150,Washington Square,1 nomination.,0,0,1,1
4151,Midnight in the Garden of Good and Evil,1 win & 4 nominations.,0,1,4,5
4152,Anaconda,6 wins & 11 nominations.,0,6,11,17
4153,G.I. Jane,2 wins & 3 nominations.,0,2,3,5
4154,Absolute Power,1 nomination,0,0,1,1
4155,Mr. Jealousy,,0,0,0,0
4156,Nothing to Lose,1 win.,0,1,0,1
4157,The Sixth Man,,0,0,0,0
4158,Nowhere,1 nomination.,0,0,1,1
4159,Austin Powers: International Man of Mystery,3 wins & 8 nominations.,0,3,8,11
4160,Good Will Hunting,Won 2 Oscars. Another 22 wins & 61 nominations.,2,22,61,85
4161,Fools Rush In,3 nominations.,0,0,3,3
4162,Mr. Magoo,2 nominations.,0,0,2,2
4163,Mr. Nice Guy,,0,0,0,0
4164,"Truth or Consequences, N.M.",,0,0,0,0
4165,A Thousand Acres,Nominated for 1 Golden Globe. Another 2 wins.,0,2,1,3
4166,The Saint,1 win & 2 nominations.,0,1,2,3
4167,Lolita,Nominated for 1 Oscar. Another 2 wins & 8 nominations.,1,2,8,11
4168,Ulee's Gold,Nominated for 1 Oscar. Another 8 wins & 16 nominations.,1,8,16,25
4169,Mousehunt,2 wins & 2 nominations.,0,2,2,4
4170,Turbo: A Power Rangers Movie,1 nomination.,0,0,1,1
4171,Welcome to Sarajevo,1 win & 2 nominations.,0,1,2,3
4172,Live Flesh,Nominated for 1 BAFTA Film Award. Another 11 wins & 13 nominations.,0,11,14,25
4173,Henry Fool,1 win & 1 nomination.,0,1,1,2
4174,Ma Vie en Rose,Won 1 Golden Globe. Another 12 wins & 7 nominations.,0,13,7,20
4175,Excess Baggage,2 wins & 3 nominations.,0,2,3,5
4176,Por el lado oscuro del camino,,0,0,0,0
4177,Mortal Kombat: Annihilation,,0,0,0,0
4178,Tomorrow Never Dies,6 wins & 10 nominations,0,6,10,16
4179,Life Is Beautiful,1 win & 2 nominations.,0,1,2,3
4180,Red Corner,4 wins.,0,4,0,4
4181,Amistad,Nominated for 4 Oscars. Another 11 wins & 39 nominations.,4,11,39,54
4182,Most Wanted,1 win & 1 nomination.,0,1,1,2
4183,Free Willy 3: The Rescue,2 wins & 2 nominations.,0,2,2,4
4184,Money Talks,1 nomination.,0,0,1,1
4185,Mad City,1 nomination.,0,0,1,1
4186,Event Horizon,1 win & 2 nominations.,0,1,2,3
4187,Amy Foster,,0,0,0,0
4188,Twin Town,1 win & 1 nomination.,0,1,1,2
4189,Eve's Bayou,12 wins & 17 nominations.,0,12,17,29
4190,Nightwatch,2 wins.,0,2,0,2
4191,Plump Fiction,,0,0,0,0
4192,An Alan Smithee Film: Burn Hollywood Burn,6 wins & 8 nominations.,0,6,8,14
4193,As Good as It Gets,Won 2 Oscars. Another 36 wins & 54 nominations.,2,36,54,92
4194,Turbulence,4 nominations.,0,0,4,4
4195,Two Girls and a Guy,,0,0,0,0
4196,Playing God,,0,0,0,0
4197,Liar Liar,4 wins & 6 nominations.,0,4,6,10
4198,Warriors of Virtue,2 nominations.,0,0,2,2
4199,Flubber,3 wins & 2 nominations.,0,3,2,5
4200,A Simple Wish,1 win & 2 nominations.,0,1,2,3
4201,A Life Less Ordinary,1 win & 3 nominations.,0,1,3,4
4202,Gang Related,,0,0,0,0
4203,Gummo,4 wins & 2 nominations.,0,4,2,6
4204,Orgazmo,,0,0,0,0
4205,Mrs Dalloway,2 wins & 1 nomination.,0,2,1,3
4206,A Smile Like Yours,1 nomination.,0,0,1,1
4207,Dulce porvenir,,0,0,0,0
4208,Oscar and Lucinda,Nominated for 1 Oscar. Another 10 wins & 6 nominations.,1,10,6,17
4209,McHale's Navy,2 wins & 2 nominations.,0,2,2,4
4210,Gridlock'd,2 wins & 1 nomination.,0,2,1,3
4211,Gattaca,Nominated for 1 Oscar. Another 6 wins & 15 nominations.,1,6,15,22
4212,B*A*P*S,2 nominations.,0,0,2,2
4213,Romy and Michele's High School Reunion,4 nominations.,0,0,4,4
4214,The Wings of the Dove,Nominated for 4 Oscars. Another 16 wins & 28 nominations.,4,16,28,48
4215,Fierce Creatures,,0,0,0,0
4216,Out to Sea,,0,0,0,0
4217,Paradise Road,1 win & 7 nominations.,0,1,7,8
4218,Rosewood,3 wins & 10 nominations.,0,3,10,13
4219,Vegas Vacation,1 nomination.,0,0,1,1
4220,Affliction,Won 1 Oscar. Another 7 wins & 19 nominations.,1,7,19,27
4221,Grosse Pointe Blank,2 wins & 8 nominations.,0,2,8,10
4222,Murder at 1600,,0,0,0,0
4223,Fireworks,23 wins & 23 nominations.,0,23,23,46
4224,Fire Down Below,1 win & 5 nominations.,0,1,5,6
4225,Firelight,2 wins & 2 nominations.,0,2,2,4
4226,The Relic,4 nominations.,0,0,4,4
4227,Mrs Brown,Nominated for 2 Oscars. Another 12 wins & 24 nominations.,2,12,24,38
4228,My Best Friend's Wedding,Nominated for 1 Oscar. Another 12 wins & 23 nominations.,1,12,23,36
4229,One Night Stand,1 win & 3 nominations.,0,1,3,4
4230,Fathers' Day,1 nomination.,0,0,1,1
4231,Perfect Blue,3 wins & 3 nominations.,0,3,3,6
4232,Anastasia,Nominated for 2 Oscars. 10 wins & 23 nominations total,2,10,23,35
4233,Metro,1 nomination,0,0,1,1
4234,Air Force One,Nominated for 2 Oscars. Another 7 wins & 11 nominations.,2,7,11,20
4235,Trial and Error,,0,0,0,0
4236,Men in Black,Won 1 Oscar. Another 21 wins & 39 nominations.,1,21,39,61
4237,George of the Jungle,1 win & 3 nominations.,0,1,3,4
4238,One Eight Seven,1 win & 1 nomination.,0,1,1,2
4239,Open Your Eyes,6 wins & 14 nominations.,0,6,14,20
4240,Wag the Dog,Nominated for 2 Oscars. Another 2 wins & 21 nominations.,2,2,21,25
4241,Air Bud,4 wins & 3 nominations.,0,4,3,7
4242,Prefontaine,,0,0,0,0
4243,The Spanish Prisoner,3 nominations.,0,0,3,3
4244,Love Jones,2 wins & 7 nominations.,0,2,7,9
4245,RocketMan,Won 1 Oscar. Another 20 wins & 78 nominations.,1,20,78,99
4246,Trojan War,,0,0,0,0
4247,Sleepers,Nominated for 1 Oscar. Another 1 win & 4 nominations.,1,1,4,6
4248,That Thing You Do!,Nominated for 1 Oscar. Another 3 wins & 7 nominations.,1,3,7,11
4249,Bound,8 wins & 13 nominations.,0,8,13,21
4250,Bordello of Blood,,0,0,0,0
4251,A Very Brady Sequel,2 nominations.,0,0,2,2
4252,Happy Gilmore,1 win & 4 nominations.,0,1,4,5
4253,Bogus,1 win & 3 nominations.,0,1,3,4
4254,Eraser,Nominated for 1 Oscar. Another 3 wins & 1 nomination.,1,3,1,5
4255,Hard Eight,2 wins & 8 nominations.,0,2,8,10
4256,Escape from L.A.,3 nominations,0,0,3,3
4257,The Arrival,1 win & 1 nomination.,0,1,1,2
4258,Trainspotting,Nominated for 1 Oscar. Another 23 wins & 34 nominations.,1,23,34,58
4259,Everyone Says I Love You,11 wins & 12 nominations.,0,11,12,23
4260,Jingle All the Way,2 wins & 4 nominations.,0,2,4,6
4261,Sling Blade,Won 1 Oscar. Another 13 wins & 15 nominations.,1,13,15,29
4262,Joe's Apartment,2 wins.,0,2,0,2
4263,The Stupids,3 wins & 5 nominations.,0,3,5,8
4264,Jerry Maguire,Won 1 Oscar. Another 25 wins & 41 nominations.,1,25,41,67
4265,The Associate,,0,0,0,0
4266,Primal Fear,Nominated for 1 Oscar. Another 10 wins & 11 nominations.,1,10,11,22
4267,Bottle Rocket,2 wins & 1 nomination.,0,2,1,3
4268,The Hunchback of Notre Dame,Nominated for 1 Oscar. 8 wins & 26 nominations total,1,8,26,35
4269,The Adventures of Pinocchio,1 win & 2 nominations.,0,1,2,3
4270,From Dusk Till Dawn,7 wins & 13 nominations.,0,7,13,20
4271,My Fellow Americans,,0,0,0,0
4272,The Nutty Professor,Won 1 Oscar. Another 9 wins & 12 nominations.,1,9,12,22
4273,The Substitute,,0,0,0,0
4274,Trees Lounge,4 nominations.,0,0,4,4
4275,Mad Dog Time,,0,0,0,0
4276,Pusher,1 win.,0,1,0,1
4277,The Sunchaser,1 nomination.,0,0,1,1
4278,Kazaam,2 nominations.,0,0,2,2
4279,Mystery Science Theater 3000: The Movie,1 nomination.,0,0,1,1
4280,Diabolique,2 wins & 1 nomination.,0,2,1,3
4281,Harriet the Spy,3 wins & 2 nominations.,0,3,2,5
4282,Curdled,2 nominations.,0,0,2,2
4283,Head Above Water,1 win & 1 nomination.,0,1,1,2
4284,Fled,,0,0,0,0
4285,Striptease,8 wins & 4 nominations.,0,8,4,12
4286,SubUrbia,1 nomination.,0,0,1,1
4287,One Fine Day,Nominated for 1 Oscar. 4 wins & 6 nominations total,1,4,6,11
4288,Spy Hard,,0,0,0,0
4289,Flipper,5 nominations.,0,0,5,5
4290,Heaven's Prisoners,1 nomination.,0,0,1,1
4291,Fargo,Won 2 Oscars. Another 81 wins & 58 nominations.,2,81,58,141
4292,A Thin Line Between Love and Hate,,0,0,0,0
4293,Flirting with Disaster,1 win & 10 nominations.,0,1,10,11
4294,Black Mask,4 nominations.,0,0,4,4
4295,Fly Away Home,Nominated for 1 Oscar. Another 5 wins & 6 nominations.,1,5,6,12
4296,Fear,1 win & 2 nominations.,0,1,2,3
4297,D3: The Mighty Ducks,2 nominations.,0,0,2,2
4298,Thinner,2 nominations.,0,0,2,2
4299,Love Is All There Is,,0,0,0,0
4300,Feeling Minnesota,,0,0,0,0
4301,Female Perversions,2 nominations.,0,0,2,2
4302,Bio-Dome,3 wins & 1 nomination.,0,3,1,4
4303,The Long Kiss Goodnight,3 nominations.,0,0,3,3
4304,Daylight,Nominated for 1 Oscar. 1 win & 4 nominations total,1,1,4,6
4305,Kids in the Hall: Brain Candy,5 nominations.,0,0,5,5
4306,A Summer's Tale,1 nomination.,0,0,1,1
4307,Waiting for Guffman,2 wins & 3 nominations,0,2,3,5
4308,First Kid,1 nomination.,0,0,1,1
4309,Kama Sutra: A Tale of Love,1 win & 1 nomination.,0,1,1,2
4310,First Contact,,0,0,0,0
4311,Kansas City,3 wins & 1 nomination.,0,3,1,4
4312,Stealing Beauty,3 wins & 11 nominations.,0,3,11,14
4313,Surviving Picasso,,0,0,0,0
4314,Phat Beach,,0,0,0,0
4315,Phenomenon,7 wins & 8 nominations,0,7,8,15
4316,Bloodsport 2,,0,0,0,0
4317,Evita,Won 1 Oscar. Another 18 wins & 43 nominations.,1,18,43,62
4318,Freeway,6 wins & 4 nominations.,0,6,4,10
4319,Executive Decision,2 wins & 2 nominations.,0,2,2,4
4320,The Trigger Effect,,0,0,0,0
4321,House Arrest,1 nomination.,0,0,1,1
4322,I Shot Andy Warhol,5 wins & 7 nominations.,0,5,7,12
4323,Night Falls on Manhattan,1 nomination.,0,0,1,1
4324,Extreme Measures,,0,0,0,0
4325,Police Story 4: First Strike,,0,0,0,0
4326,Courage Under Fire,9 wins & 7 nominations.,0,9,7,16
4327,Solo,,0,0,0,0
4328,The Mirror Has Two Faces,Nominated for 2 Oscars. Another 4 wins & 9 nominations.,2,4,9,15
4329,Some Mother's Son,4 wins & 1 nomination.,0,4,1,5
4330,Jude,5 wins & 6 nominations.,0,5,6,11
4331,The Island of Dr. Moreau,2 wins & 10 nominations.,0,2,10,12
4332,A Time to Kill,7 wins & 12 nominations.,0,7,12,19
4333,Crash: Extra�os placeres,,0,0,0,0
4334,To Gillian on Her 37th Birthday,1 win.,0,1,0,1
4335,Box of Moon Light,,0,0,0,0
4336,Foxfire,,0,0,0,0
4337,Blood and Wine,1 win & 1 nomination.,0,1,1,2
4338,Eye for an Eye,,0,0,0,0
4339,The Juror,1 win & 2 nominations.,0,1,2,3
4340,Tin Cup,Nominated for 1 Golden Globe. Another 3 nominations.,0,0,4,4
4341,Kissed,7 wins & 10 nominations.,0,7,10,17
4342,The Van,1 nomination.,0,0,1,1
4343,Space Jam,5 wins & 7 nominations,0,5,7,12
4344,Lone Star,Nominated for 1 Oscar. Another 15 wins & 18 nominations.,1,15,18,34
4345,Kingpin,,0,0,0,0
4346,Swingers,3 wins & 3 nominations.,0,3,3,6
4347,Garras,,0,0,0,0
4348,Big Night,9 wins & 17 nominations.,0,9,17,26
4349,Muppet Treasure Island,5 nominations,0,0,5,5
4350,All Dogs Go to Heaven 2,3 nominations.,0,0,3,3
4351,Twister,Nominated for 2 Oscars. 11 wins & 17 nominations total,2,11,17,30
4352,It's My Party,1 nomination.,0,0,1,1
4353,Albino Alligator,1 nomination.,0,0,1,1
4354,El libro de cabecera,,0,0,0,0
4355,Alaska,3 nominations.,0,0,3,3
4356,Last Man Standing,,0,0,0,0
4357,Broken Arrow,1 win & 3 nominations.,0,1,3,4
4358,Jack,6 nominations.,0,0,6,6
4359,The Great White Hype,,0,0,0,0
4360,The Chamber,2 nominations.,0,0,2,2
4361,Girl 6,1 nomination.,0,0,1,1
4362,Beavis and Butt-Head Do America,1 win & 4 nominations.,0,1,4,5
4363,Bad Moon,,0,0,0,0
4364,Set It Off,5 wins & 6 nominations.,0,5,6,11
4365,Ghosts of Mississippi,Nominated for 2 Oscars. Another 2 wins & 7 nominations.,2,2,7,11
4366,Carried Away,,0,0,0,0
4367,Santa with Muscles,,0,0,0,0
4368,Carpool,2 wins.,0,2,0,2
4369,DragonHeart,Nominated for 1 Oscar. Another 3 wins & 9 nominations.,1,3,9,13
4370,The Quest,1 nomination.,0,0,1,1
4371,101 Dalmatians,Nominated for 1 BAFTA Film Award. Another 3 wins & 9 nominations.,0,3,10,13
4372,Beautiful Thing,4 wins & 3 nominations.,0,4,3,7
4373,High School High,,0,0,0,0
4374,Twelfth Night or What You Will,,0,0,0,0
4375,The Cable Guy,3 wins & 2 nominations.,0,3,2,5
4376,The Rock,Nominated for 1 Oscar. Another 9 wins & 8 nominations.,1,9,8,18
4377,The Phantom,3 wins.,0,3,0,3
4378,Lawnmower Man 2: Beyond Cyberspace,1 nomination.,0,0,1,1
4379,Barb Wire,1 win & 7 nominations.,0,1,7,8
4380,Don't Be a Menace to South Central While Drinking Your Juice in the Hood,1 nomination.,0,0,1,1
4381,Moll Flanders,4 nominations.,0,0,4,4
4382,The Craft,1 win & 7 nominations,0,1,7,8
4383,Chain Reaction,1 nomination.,0,0,1,1
4384,Larger Than Life,,0,0,0,0
4385,Ridicule,Nominated for 1 Oscar. Another 20 wins & 16 nominations.,1,20,16,37
4386,Manny & Lo,2 nominations.,0,0,2,2
4387,The Glimmer Man,,0,0,0,0
4388,Down Periscope,,0,0,0,0
4389,The Crucible,Nominated for 2 Oscars. 4 wins & 29 nominations total,2,4,29,35
4390,Scream,11 wins & 11 nominations.,0,11,11,22
4391,The Crow: City of Angels,2 wins & 3 nominations.,0,2,3,5
4392,Beautiful Girls,1 win & 3 nominations,0,1,3,4
4393,In Love and War,1 nomination.,0,0,1,1
4394,Celtic Pride,,0,0,0,0
4395,Eddie,1 win & 2 nominations.,0,1,2,3
4396,Michael Collins,Nominated for 2 Oscars. Another 4 wins & 15 nominations.,2,4,15,21
4397,Caught,,0,0,0,0
4398,Irma Vep,2 wins & 3 nominations.,0,2,3,5
4399,Ed,4 nominations.,0,0,4,4
4400,The Portrait of a Lady,Nominated for 2 Oscars. Another 5 wins & 13 nominations.,2,5,13,20
4401,Mission: Impossible,5 wins & 30 nominations.,0,5,30,35
4402,Michael,1 nomination,0,0,1,1
4403,2 Days in the Valley,1 nomination.,0,0,1,1
4404,Two Much,5 nominations,0,0,5,5
4405,Last Dance,1 nomination,0,0,1,1
4406,Two If by Sea,,0,0,0,0
4407,Secrets & Lies,,0,0,0,0
4408,The Secret Agent,1 nomination.,0,0,1,1
4409,Boys,9 wins & 8 nominations.,0,9,8,17
4410,The Funeral,2 wins & 7 nominations.,0,2,7,9
4411,Dunston Checks In,4 nominations.,0,0,4,4
4412,Sgt. Bilko,1 win.,0,1,0,1
4413,Ransom,3 wins & 5 nominations.,0,3,5,8
4414,If Lucy Fell,,0,0,0,0
4415,Homeward Bound II: Lost in San Francisco,3 nominations.,0,0,3,3
4416,The Evening Star,Nominated for 1 Golden Globe. Another 6 wins & 2 nominations.,0,6,3,9
4417,White Squall,1 nomination.,0,0,1,1
4418,Claroscuro,,0,0,0,0
4419,Mr. Toad's Wild Ride,2 wins.,0,2,0,2
4420,She's the One,3 nominations.,0,0,3,3
4421,The Birdcage,Nominated for 1 Oscar. Another 7 wins & 24 nominations.,1,7,24,32
4422,Mr. Wrong,1 win & 2 nominations.,0,1,2,3
4423,Shiloh,4 wins.,0,4,0,4
4424,Brassed Off,Nominated for 1 BAFTA Film Award. Another 10 wins & 6 nominations.,0,10,7,17
4425,The Pallbearer,1 nomination.,0,0,1,1
4426,Independence Day,Won 1 Oscar. 35 wins & 35 nominations total,1,35,35,71
4427,Basquiat,2 wins & 3 nominations.,0,2,3,5
4428,Before and After,,0,0,0,0
4429,The Rich Man's Wife,,0,0,0,0
4430,Race the Sun,,0,0,0,0
4431,Mrs. Winterbourne,1 nomination.,0,0,1,1
4432,Maximum Risk,,0,0,0,0
4433,The First Wives Club,Nominated for 1 Oscar. Another 3 wins & 7 nominations.,1,3,7,11
4434,Muertos de miedo,,0,0,0,0
4435,Mulholland Falls,1 win & 1 nomination.,0,1,1,2
4436,The Spitfire Grill,3 wins.,0,3,0,3
4437,The Fan,1 win & 3 nominations.,0,1,3,4
4438,Multiplicity,,0,0,0,0
4439,Matilda,3 wins & 7 nominations,0,3,7,10
4440,The People vs. Larry Flynt,Nominated for 2 Oscars. Another 22 wins & 33 nominations.,2,22,33,57
4441,The Preacher's Wife,Nominated for 1 Oscar. Another 4 wins & 6 nominations.,1,4,6,11
4442,James and the Giant Peach,Nominated for 1 Oscar. Another 4 wins & 12 nominations.,1,4,12,17
4443,Citizen Ruth,3 wins & 2 nominations.,0,3,2,5
4444,Shall We Dance?,55 wins & 7 nominations.,0,55,7,62
4445,City Hall,1 nomination.,0,0,1,1
4446,Romeo + Juliet,Nominated for 1 Oscar. Another 15 wins & 28 nominations.,1,15,28,44
4447,Hellraiser: Bloodline,1 win & 2 nominations.,0,1,2,3
4448,Mother Night,,0,0,0,0
4449,Marvin's Room,Nominated for 1 Oscar. Another 4 wins & 12 nominations.,1,4,12,17
4450,The English Patient,Won 9 Oscars. Another 53 wins & 77 nominations.,9,53,77,139
4451,Emma,Won 1 Oscar. Another 2 wins & 7 nominations.,1,2,7,10
4452,Mary Reilly,6 nominations.,0,0,6,6
4453,Bed of Roses,,0,0,0,0
4454,The Eighth Day,Nominated for 1 Golden Globe. Another 6 wins & 5 nominations.,0,6,6,12
4455,Mars Attacks!,3 wins & 19 nominations.,0,3,19,22
4456,Outbreak,5 wins & 5 nominations,0,5,5,10
4457,The Doom Generation,1 nomination.,0,0,1,1
4458,Othello,3 nominations.,0,0,3,3
4459,Bushwhacked,,0,0,0,0
4460,Jury Duty,1 win & 1 nomination.,0,1,1,2
4461,Under Siege 2: Dark Territory,,0,0,0,0
4462,Now and Then,1 nomination.,0,0,1,1
4463,Dangerous Minds,6 wins & 8 nominations.,0,6,8,14
4464,Operation Dumbo Drop,,0,0,0,0
4465,Adi�s a Las Vegas,,0,0,0,0
4466,Grumpier Old Men,2 wins & 2 nominations.,0,2,2,4
4467,The Fantasticks,,0,0,0,0
4468,Waiting to Exhale,9 wins & 10 nominations.,0,9,10,19
4469,Things to Do in Denver When You're Dead,2 wins,0,2,0,2
4470,Jumanji,4 wins & 11 nominations.,0,4,11,15
4471,Three Wishes,1 nomination.,0,0,1,1
4472,Unstrung Heroes,Nominated for 1 Oscar. Another 2 nominations.,1,0,2,3
4473,The Flower of My Secret,5 wins & 13 nominations.,0,5,13,18
4474,Candyman: Farewell to the Flesh,,0,0,0,0
4475,The Englishman Who Went Up a Hill But Came Down a Mountain,1 win & 1 nomination.,0,1,1,2
4476,Casper,4 wins & 5 nominations.,0,4,5,9
4477,Cutthroat Island,1 nomination.,0,0,1,1
4478,Ace Ventura: When Nature Calls,7 wins & 6 nominations,0,7,6,13
4479,First Knight,,0,0,0,0
4480,Bye Bye Love,1 nomination.,0,0,1,1
4481,Gordy,1 win.,0,1,0,1
4482,Flirt,,0,0,0,0
4483,Canadian Bacon,,0,0,0,0
4484,Strange Days,2 wins & 4 nominations.,0,2,4,6
4485,Miami Rhapsody,1 nomination,0,0,1,1
4486,The Day of the Beast,16 wins & 14 nominations.,0,16,14,30
4487,Carrington,7 wins & 9 nominations total,0,7,9,16
4488,C�rculo de amigos,,0,0,0,0
4489,The Last Supper,1 win & 1 nomination.,0,1,1,2
4490,Angus,1 nomination.,0,0,1,1
4491,Stuart Saves His Family,2 nominations.,0,0,2,2
4492,Fluke,2 nominations,0,0,2,2
4493,Angels and Insects,Nominated for 1 Oscar. Another 2 wins & 2 nominations.,1,2,2,5
4494,Billy Madison,1 nomination.,0,0,1,1
4495,Casino,Nominated for 1 Oscar. Another 4 wins & 10 nominations.,1,4,10,15
4496,Hackers,,0,0,0,0
4497,Just Cause,1 win.,0,1,0,1
4498,Tales from the Hood,,0,0,0,0
4499,Mighty Aphrodite,Won 1 Oscar. Another 11 wins & 13 nominations.,1,11,13,25
4500,Toy Story,Nominated for 3 Oscars. Another 27 wins & 20 nominations.,3,27,20,50
4501,Get Shorty,Won 1 Golden Globe. Another 5 wins & 16 nominations.,0,6,16,22
4502,Jade,2 nominations,0,0,2,2
4503,The Addiction,5 wins & 4 nominations.,0,5,4,9
4504,Napoleon,4 wins.,0,4,0,4
4505,The Brady Bunch Movie,3 nominations.,0,0,3,3
4506,Mad Love,,0,0,0,0
4507,The Bridges of Madison County,Nominated for 1 Oscar. Another 7 wins & 17 nominations.,1,7,17,25
4508,Mallrats,,0,0,0,0
4509,Village of the Damned,2 nominations.,0,0,2,2
4510,The Brothers McMullen,4 wins & 1 nomination.,0,4,1,5
4511,Congo,2 wins & 11 nominations,0,2,11,13
4512,Total Eclipse,1 nomination.,0,0,1,1
4513,A Walk in the Clouds,1 win & 6 nominations.,0,1,6,7
4514,Johnny Mnemonic,2 wins & 3 nominations.,0,2,3,5
4515,Mortal Kombat,1 win & 3 nominations,0,1,3,4
4516,Friday,1 win & 5 nominations.,0,1,5,6
4517,Twelve Monkeys,,0,0,0,0
4518,Major Payne,,0,0,0,0
4519,The Amazing Panda Adventure,3 nominations.,0,0,3,3
4520,Mr. Holland's Opus,Nominated for 1 Oscar. Another 5 wins & 4 nominations.,1,5,4,10
4521,The American President,Nominated for 1 Oscar. Another 1 win & 9 nominations.,1,1,9,11
4522,Jeffrey,1 win & 4 nominations.,0,1,4,5
4523,The Basketball Diaries,,0,0,0,0
4524,Murder in the First,2 wins & 2 nominations.,0,2,2,4
4525,The Horseman on the Roof,4 wins & 8 nominations.,0,4,8,12
4526,Magic in the Water,2 wins & 5 nominations.,0,2,5,7
4527,Jefferson in Paris,2 nominations.,0,0,2,2
4528,Clockers,6 nominations,0,0,6,6
4529,Boys on the Side,1 win & 2 nominations.,0,1,2,3
4530,Mute Witness,3 wins & 3 nominations.,0,3,3,6
4531,The Baby-Sitters Club,2 wins & 1 nomination.,0,2,1,3
4532,3 Ninjas Knuckle Up,2 nominations.,0,0,2,2
4533,Clueless,6 wins & 11 nominations.,0,6,11,17
4534,The Big Green,,0,0,0,0
4535,Born to Be Wild,2 wins.,0,2,0,2
4536,Braveheart,Won 5 Oscars. Another 28 wins & 34 nominations.,5,28,34,67
4537,Georgia,Nominated for 1 Oscar. Another 4 wins & 6 nominations.,1,4,6,11
4538,Funny Bones,8 wins.,0,8,0,8
4539,Never Talk to Strangers,,0,0,0,0
4540,Ghost in the Shell,3 wins & 6 nominations,0,3,6,9
4541,Mighty Morphin Power Rangers: The Movie,1 nomination.,0,0,1,1
4542,Ulysses' Gaze,12 wins & 7 nominations.,0,12,7,19
4543,Two Bits,2 nominations.,0,0,2,2
4544,Nixon,Nominated for 4 Oscars. Another 11 wins & 14 nominations.,4,11,14,29
4545,Tales from the Crypt: Demon Knight,2 wins & 1 nomination.,0,2,1,3
4546,Judge Dredd,2 wins & 5 nominations.,0,2,5,7
4547,"To Wong Foo Thanks for Everything, Julie Newmar",Nominated for 2 Golden Globes. Another 1 nomination.,0,0,3,3
4548,To Die For,Won 1 Golden Globe. Another 6 wins & 13 nominations.,0,7,13,20
4549,The Jerky Boys,,0,0,0,0
4550,Gold Diggers: The Secret of Bear Mountain,1 win & 1 nomination.,0,1,1,2
4551,Moonlight and Valentino,,0,0,0,0
4552,Four Rooms,1 win & 1 nomination.,0,1,1,2
4553,Crimson Tide,Nominated for 3 Oscars. Another 5 wins & 6 nominations.,3,5,6,14
4554,GoldenEye,2 wins & 8 nominations total,0,2,8,10
4555,The Crossing Guard,Nominated for 1 Golden Globe. Another 3 nominations.,0,0,4,4
4556,Virtuosity,1 nomination.,0,0,1,1
4557,Forget Paris,1 win.,0,1,0,1
4558,An Awfully Big Adventure,2 nominations.,0,0,2,2
4559,Tall Tale,,0,0,0,0
4560,Nine Months,1 win & 2 nominations,0,1,2,3
4561,Vampire in Brooklyn,,0,0,0,0
4562,The City of Lost Children,5 wins & 14 nominations.,0,5,14,19
4563,New Jersey Drive,3 nominations.,0,0,3,3
4564,Top Dog,,0,0,0,0
4565,The Incredibly True Adventure of Two Girls in Love,1 win.,0,1,0,1
4566,The Indian in the Cupboard,1 win & 6 nominations,0,1,6,7
4567,Jack & Sarah,6 nominations.,0,0,6,6
4568,Copycat,2 wins & 1 nomination.,0,2,1,3
4569,French Kiss,2 nominations.,0,0,2,2
4570,Blue in the Face,2 nominations.,0,0,2,2
4571,Nick of Time,,0,0,0,0
4572,Money Train,1 nomination,0,0,1,1
4573,Tommy Boy,1 win & 2 nominations.,0,1,2,3
4574,The Grass Harp,3 wins.,0,3,0,3
4575,Free Willy 2: The Adventure Home,2 wins & 2 nominations.,0,2,2,4
4576,Tom and Huck,1 win & 5 nominations.,0,1,5,6
4577,Tank Girl,,0,0,0,0
4578,Halloween: The Curse of Michael Myers,3 wins & 1 nomination,0,3,1,4
4579,Sudden Death,,0,0,0,0
4580,Sense and Sensibility,Won 1 Oscar. Another 32 wins & 49 nominations.,1,32,49,82
4581,Pocahontas,Won 2 Oscars. Another 13 wins & 7 nominations.,2,13,7,22
4582,Killer: A Journal of Murder,2 wins & 2 nominations.,0,2,2,4
4583,Restoration,Won 2 Oscars. Another 2 nominations.,2,0,2,4
4584,"Babe, el puerquito valiente",,0,0,0,0
4585,Dr. Jekyll and Ms. Hyde,4 nominations.,0,0,4,4
4586,Die Hard with a Vengeance,2 wins & 3 nominations.,0,2,3,5
4587,Delta of Venus,,0,0,0,0
4588,The Scarlet Letter,1 win & 10 nominations.,0,1,10,11
4589,Beyond the Clouds,3 wins & 6 nominations.,0,3,6,9
4590,Wild Bill,Nominated for 1 BAFTA Film Award. Another 3 wins & 7 nominations.,0,3,8,11
4591,R�pida y mortal,,0,0,0,0
4592,Batman Forever,Nominated for 3 Oscars. Another 10 wins & 23 nominations.,3,10,23,36
4593,Something to Talk About,Nominated for 1 Golden Globe. Another 1 win & 2 nominations.,0,1,3,4
4594,The Net,2 wins.,0,2,0,2
4595,Rob Roy,Nominated for 1 Oscar. Another 2 wins & 4 nominations.,1,2,4,7
4596,Higher Learning,1 win & 1 nomination.,0,1,1,2
4597,Balto,5 nominations.,0,0,5,5
4598,Roommates,Nominated for 1 Oscar. Another 1 nomination.,1,0,1,2
4599,Father of the Bride Part II,1 win & 2 nominations.,0,1,2,3
4600,Hideaway,1 nomination.,0,0,1,1
4601,A Kid in King Arthur's Court,1 nomination.,0,0,1,1
4602,Apollo 13,Won 2 Oscars. 28 wins & 59 nominations total,2,28,59,89
4603,Waterworld,Nominated for 1 Oscar. Another 6 wins & 8 nominations.,1,6,8,15
4604,La C�r�monie,,0,0,0,0
4605,Welcome to the Dollhouse,4 wins & 17 nominations.,0,4,17,21
4606,Land and Freedom,8 wins & 5 nominations.,0,8,5,13
4607,The Star Maker,Nominated for 1 Oscar. Another 13 wins & 15 nominations.,1,13,15,29
4608,La Haine,8 wins & 15 nominations.,0,8,15,23
4609,Beyond Rangoon,2 wins & 3 nominations.,0,2,3,5
4610,Dead Presidents,2 nominations.,0,0,2,2
4611,Devil in a Blue Dress,3 wins & 13 nominations.,0,3,13,16
4612,Dead Man,5 wins & 14 nominations.,0,5,14,19
4613,Wings of Courage,,0,0,0,0
4614,Se7en,Nominated for 1 Oscar. 29 wins & 42 nominations total,1,29,42,72
4615,Showgirls,10 wins & 10 nominations,0,10,10,20
4616,Dead Man Walking,Won 1 Oscar. Another 22 wins & 23 nominations.,1,22,23,46
4617,El triturador,,0,0,0,0
4618,Sabrina,Won 1 Oscar. Another 6 wins & 8 nominations.,1,6,8,15
4619,Houseguest,,0,0,0,0
4620,When Night Is Falling,5 nominations.,0,0,5,5
4621,A Month by the Lake,,0,0,0,0
4622,White Man's Burden,,0,0,0,0
4623,The Underneath,1 nomination.,0,0,1,1
4624,Last of the Dogmen,,0,0,0,0
4625,Desperado,1 win & 5 nominations.,0,1,5,6
4626,Powder,1 win & 1 nomination.,0,1,1,2
4627,Empire Records,1 win.,0,1,0,1
4628,Bad Boys,4 nominations,0,0,4,4
4629,Lord of Illusions,2 wins & 1 nomination.,0,2,1,3
4630,Kids,1 win & 5 nominations,0,1,5,6
4631,How to Make an American Quilt,4 nominations.,0,0,4,4
4632,The Perez Family,,0,0,0,0
4633,Kicking and Screaming,2 nominations.,0,0,2,2
4634,Antonia's Line,Won 1 Oscar. Another 7 wins & 10 nominations.,1,7,10,18
4635,While You Were Sleeping,4 wins & 5 nominations.,0,4,5,9
4636,Home for the Holidays,2 nominations.,0,0,2,2
4637,Panther,2 wins & 2 nominations.,0,2,2,4
4638,Separate Lives,,0,0,0,0
4639,Kiss of Death,1 nomination.,0,0,1,1
4640,Rumble in the Bronx,2 wins & 11 nominations.,0,2,11,13
4641,Smoke,11 wins & 9 nominations.,0,11,9,20
4642,Assassins,1 win & 1 nomination.,0,1,1,2
4643,Richard III,Nominated for 2 Oscars. 7 wins & 12 nominations total,2,7,12,21
4644,A Little Princess,Nominated for 2 Oscars. Another 3 wins & 7 nominations.,2,3,7,12
4645,Living in Oblivion,7 wins & 8 nominations,0,7,8,15
4646,Before Sunrise,1 win & 7 nominations.,0,1,7,8
4647,The White Balloon,5 wins & 4 nominations.,0,5,4,9
4648,The Usual Suspects,Won 2 Oscars. Another 35 wins & 17 nominations.,2,35,17,54
4649,Asesinos cibern�ticos,,0,0,0,0
4650,Heavy Weights,,0,0,0,0
4651,Heavy,3 wins & 3 nominations.,0,3,3,6
4652,Far from Home: The Adventures of Yellow Dog,3 nominations.,0,0,3,3
4653,Species,3 wins & 6 nominations.,0,3,6,9
4654,Party Girl,1 nomination,0,0,1,1
4655,A Single Girl,1 nomination.,0,0,1,1
4656,Losing Isaiah,1 nomination.,0,0,1,1
4657,Dr�cula: Muerto pero feliz,,0,0,0,0
4658,A Goofy Movie,5 nominations.,0,0,5,5
4659,A Midwinter's Tale,1 win & 1 nomination.,0,1,1,2
4660,Senior Trip,,0,0,0,0
4661,The Prophecy,2 wins & 2 nominations.,0,2,2,4
4662,Destiny Turns on the Radio,,0,0,0,0
4663,La piedra y el ping�ino,,0,0,0,0
4664,Dolores Claiborne,1 win & 8 nominations.,0,1,8,9
4665,Cobb,1 nomination.,0,0,1,1
4666,Go Fish,4 wins & 4 nominations.,0,4,4,8
4667,Trading Mom,,0,0,0,0
4668,The Scout,,0,0,0,0
4669,Iron Will,,0,0,0,0
4670,Naked Gun 33 1/3: The Final Insult,3 wins.,0,3,0,3
4671,Chasers,,0,0,0,0
4672,Nadja,2 wins & 5 nominations.,0,2,5,7
4673,El Libro de la Selva,,0,0,0,0
4674,A Good Man in Africa,,0,0,0,0
4675,Ladybird Ladybird,6 wins & 3 nominations.,0,6,3,9
4676,Mixed Nuts,1 nomination.,0,0,1,1
4677,Princess Caraboo,,0,0,0,0
4678,Double Dragon,,0,0,0,0
4679,Little Odessa,4 wins & 7 nominations.,0,4,7,11
4680,The Next Karate Kid,1 win.,0,1,0,1
4681,Cops and Robbersons,,0,0,0,0
4682,In the Army Now,,0,0,0,0
4683,Above the Rim,1 nomination.,0,0,1,1
4684,Terminal Velocity,,0,0,0,0
4685,Highlander: The Final Dimension,1 nomination.,0,0,1,1
4686,New Nightmare,3 wins & 7 nominations,0,3,7,10
4687,"Las aventuras de Priscilla, reina del desierto",,0,0,0,0
4688,Milk Money,1 nomination.,0,0,1,1
4689,The Glass Shield,1 nomination.,0,0,1,1
4690,The Santa Clause,2 wins & 8 nominations.,0,2,8,10
4691,Little Women,Won 1 Oscar. Another 75 wins & 216 nominations.,1,75,216,292
4692,Texas Chainsaw Massacre: The Next Generation,,0,0,0,0
4693,Wild Reeds,9 wins & 7 nominations.,0,9,7,16
4694,Nell,Nominated for 1 Oscar. Another 5 wins & 6 nominations.,1,5,6,12
4695,Double Happiness,6 wins & 6 nominations.,0,6,6,12
4696,The Crow,5 wins & 7 nominations.,0,5,7,12
4697,Sleep with Me,1 nomination.,0,0,1,1
4698,The Air Up There,,0,0,0,0
4699,I'll Do Anything,1 win & 2 nominations.,0,1,2,3
4700,Natural Born Killers,Nominated for 1 Golden Globe. Another 5 wins & 10 nominations.,0,5,11,16
4701,The Cowboy Way,,0,0,0,0
4702,Miracle on 34th Street,Won 3 Oscars. Another 5 wins & 1 nomination.,3,5,1,9
4703,Sister My Sister,4 wins & 1 nomination.,0,4,1,5
4704,Silent Fall,1 nomination.,0,0,1,1
4705,It Could Happen to You,,0,0,0,0
4706,Jason's Lyric,1 nomination.,0,0,1,1
4707,Clerks,6 wins & 10 nominations.,0,6,10,16
4708,Clear and Present Danger,Nominated for 2 Oscars. 3 wins & 11 nominations total,2,3,11,16
4709,China Moon,,0,0,0,0
4710,The Shadow,4 nominations.,0,0,4,4
4711,Brainscan,1 nomination.,0,0,1,1
4712,La boda de Muriel,,0,0,0,0
4713,Mrs. Parker and the Vicious Circle,Nominated for 1 Golden Globe. Another 2 wins & 7 nominations.,0,2,8,10
4714,The Shawshank Redemption,Nominated for 7 Oscars. 21 wins & 43 nominations total,7,21,43,71
4715,The Specialist,4 wins & 7 nominations,0,4,7,11
4716,The Pagemaster,5 nominations.,0,0,5,5
4717,The Paper,,0,0,0,0
4718,Clean Slate,,0,0,0,0
4719,Radioland Murders,,0,0,0,0
4720,Mosquito,1 nomination.,0,0,1,1
4721,The Browning Version,Nominated for 2 BAFTA Film Awards. Another 7 wins & 1 nomination.,0,7,3,10
4722,White Fang 2: Myth of the White Wolf,,0,0,0,0
4723,Il Postino,Won 1 Oscar. Another 31 wins & 20 nominations.,1,31,20,52
4724,La fille de d'Artagnan,,0,0,0,0
4725,Baby's Day Out,,0,0,0,0
4726,Reality Bites,2 nominations,0,0,2,2
4727,Major League II,1 win & 1 nomination.,0,1,1,2
4728,Disclosure,2 wins & 2 nominations,0,2,2,4
4729,Backbeat,5 wins & 4 nominations total,0,5,4,9
4730,Chungking Express,,0,0,0,0
4731,Ready to Wear,3 wins & 3 nominations.,0,3,3,6
4732,Rapa Nui,1 win & 1 nomination.,0,1,1,2
4733,Vanya on 42nd Street,2 wins & 12 nominations.,0,2,12,14
4734,City Slickers II: The Legend of Curly's Gold,2 nominations.,0,0,2,2
4735,Getting Even with Dad,2 nominations.,0,0,2,2
4736,Shallow Grave,14 wins & 1 nomination.,0,14,1,15
4737,Holy Matrimony,,0,0,0,0
4738,Immortal Beloved,1 nomination,0,0,1,1
4739,Quiz Show,Nominated for 4 Oscars. Another 6 wins & 32 nominations.,4,6,32,42
4740,Clifford,,0,0,0,0
4741,Color of Night,2 wins & 11 nominations.,0,2,11,13
4742,A Low Down Dirty Shame,1 nomination.,0,0,1,1
4743,Trapped in Paradise,,0,0,0,0
4744,Don Juan DeMarco,Nominated for 1 Oscar. Another 4 wins & 4 nominations.,1,4,4,9
4745,The Client,Nominated for 1 Oscar. Another 3 wins & 3 nominations.,1,3,3,7
4746,It's Pat: The Movie,1 win & 7 nominations.,0,1,7,8
4747,My Girl 2,1 win & 2 nominations.,0,1,2,3
4748,The Swan Princess,1 win & 8 nominations.,0,1,8,9
4749,Jimmy Hollywood,,0,0,0,0
4750,The Hudsucker Proxy,3 wins & 4 nominations.,0,3,4,7
4751,Pulgarcita,,0,0,0,0
4752,My Father the Hero,1 nomination,0,0,1,1
4753,Pulp Fiction,Won 1 Oscar. Another 69 wins & 75 nominations.,1,69,75,145
4754,Amateur,1 win & 2 nominations.,0,1,2,3
4755,The Sum of Us,6 wins & 5 nominations.,0,6,5,11
4756,Renaissance Man,,0,0,0,0
4757,"Little Indian, Big City",,0,0,0,0
4758,Little Giants,,0,0,0,0
4759,3 Ninjas Kick Back,3 nominations.,0,0,3,3
4760,I.Q.,,0,0,0,0
4761,The Chase,,0,0,0,0
4762,True Lies,Nominated for 1 Oscar. Another 8 wins & 22 nominations.,1,8,22,31
4763,Little Big League,2 nominations.,0,0,2,2
4764,Serial Mom,1 nomination.,0,0,1,1
4765,Queen Margot,Nominated for 1 Oscar. Another 10 wins & 16 nominations.,1,10,16,27
4766,The Secret of Roan Inish,1 win & 9 nominations.,0,1,9,10
4767,Bad Girls,,0,0,0,0
4768,Before the Rain,Nominated for 1 Oscar. Another 24 wins & 4 nominations.,1,24,4,29
4769,Fresh,4 wins & 4 nominations.,0,4,4,8
4770,Ed Wood,Won 2 Oscars. Another 25 wins & 34 nominations.,2,25,34,61
4771,Dumb and Dumber,5 wins & 3 nominations.,0,5,3,8
4772,Wyatt Earp,Nominated for 1 Oscar. 3 wins & 7 nominations total,1,3,7,11
4773,The Mask,Nominated for 1 Oscar. Another 6 wins & 20 nominations.,1,6,20,27
4774,Farinelli,Nominated for 1 Oscar. Another 6 wins & 3 nominations.,1,6,3,10
4775,When a Man Loves a Woman,4 nominations.,0,0,4,4
4776,On Deadly Ground,1 win & 6 nominations.,0,1,6,7
4777,Oleanna,1 nomination.,0,0,1,1
4778,Legends of the Fall,Won 1 Oscar. 3 wins & 12 nominations total,1,3,12,16
4779,Three Colors: Red,Nominated for 3 Oscars. Another 19 wins & 26 nominations.,3,19,26,48
4780,8 Seconds,,0,0,0,0
4781,Three Colors: White,2 wins & 7 nominations.,0,2,7,9
4782,Burnt by the Sun,Won 1 Oscar. Another 4 wins & 10 nominations.,1,4,10,15
4783,"Car 54, Where Are You?",2 wins & 2 nominations.,0,2,2,4
4784,The War,1 win & 3 nominations,0,1,3,4
4785,The Last Seduction,Nominated for 1 BAFTA Film Award. Another 9 wins & 9 nominations.,0,9,10,19
4786,Intersection,2 wins.,0,2,0,2
4787,A Simple Twist of Fate,2 nominations.,0,0,2,2
4788,The Puppet Masters,2 nominations.,0,0,2,2
4789,Crooklyn,3 nominations.,0,0,3,3
4790,Interview with the Vampire: The Vampire Chronicles,Nominated for 2 Oscars. 24 wins & 36 nominations total,2,24,36,62
4791,Greedy,,0,0,0,0
4792,Surviving the Game,1 nomination.,0,0,1,1
4793,Lassie,1 win & 1 nomination.,0,1,1,2
4794,Threesome,,0,0,0,0
4795,I Can't Sleep,3 nominations.,0,0,3,3
4796,The Road to Wellville,3 nominations.,0,0,3,3
4797,Junior,Nominated for 1 Oscar. Another 4 nominations.,1,0,4,5
4798,Speed,Won 2 Oscars. Another 18 wins & 20 nominations.,2,18,20,40
4799,Through the Olive Trees,5 wins & 7 nominations.,0,5,7,12
4800,Blank Check,,0,0,0,0
4801,Spanking the Monkey,3 wins & 5 nominations.,0,3,5,8
4802,Swimming with Sharks,4 wins & 4 nominations.,0,4,4,8
4803,Mary Shelley's Frankenstein,Nominated for 1 Oscar. Another 19 nominations.,1,0,19,20
4804,The Ref,1 win & 1 nomination.,0,1,1,2
4805,Andre,4 nominations.,0,0,4,4
4806,The Legend of Drunken Master,3 wins & 1 nomination.,0,3,1,4
4807,PCU,,0,0,0,0
4808,The Favor,,0,0,0,0
4809,The Madness of King George,Won 1 Oscar. Another 15 wins & 20 nominations.,1,15,20,36
4810,Wolf,2 wins & 10 nominations.,0,2,10,12
4811,Love Affair,,0,0,0,0
4812,Angie,1 nomination.,0,0,1,1
4813,Stargate: la puerta del tiempo,,0,0,0,0
4814,Angels in the Outfield,1 win & 4 nominations.,0,1,4,5
4815,Drop Zone,,0,0,0,0
4816,There Goes My Baby,1 nomination.,0,0,1,1
4817,Maverick,Nominated for 1 Oscar. Another 1 win & 1 nomination.,1,1,1,3
4818,Dance Me Outside,4 wins & 2 nominations.,0,4,2,6
4819,Star Trek: Generations,2 wins & 4 nominations.,0,2,4,6
4820,With Honors,Nominated for 1 Golden Globe. Another 3 nominations.,0,0,4,4
4821,The Little Rascals,2 wins.,0,2,0,2
4822,De amor y de sombras,,0,0,0,0
4823,The Lion King,Won 2 Oscars. 39 wins & 35 nominations total,2,39,35,76
4824,Guarding Tess,Nominated for 1 Golden Globe. Another 1 nomination.,0,0,2,2
4825,The Flintstones,6 wins & 10 nominations.,0,6,10,16
4826,Street Fighter,2 nominations.,0,0,2,2
4827,D2: The Mighty Ducks,,0,0,0,0
4828,Wagons East,,0,0,0,0
4829,Camp Nowhere,,0,0,0,0
4830,Black Beauty,1 win & 1 nomination.,0,1,1,2
4831,The River Wild,Nominated for 2 Golden Globes. Another 2 nominations.,0,0,4,4
4832,Only You,,0,0,0,0
4833,Squanto: A Warrior's Tale,,0,0,0,0
4834,S.F.W.,5 nominations.,0,0,5,5
4835,Maybe... Maybe Not,10 wins & 1 nomination.,0,10,1,11
4836,Blankman,,0,0,0,0
4837,Lightning Jack,,0,0,0,0
4838,Death Machine,1 win & 2 nominations.,0,1,2,3
4839,Blue Chips,1 nomination.,0,0,1,1
4840,A Pure Formality,5 wins & 9 nominations.,0,5,9,14
4841,Eat Drink Man Woman,Nominated for 1 Oscar. Another 7 wins & 15 nominations.,1,7,15,23
4842,Criaturas celestiales,,0,0,0,0
4843,Mi adorable delincuente,,0,0,0,0
4844,Airheads,,0,0,0,0
4845,Blue Sky,Won 1 Oscar. Another 3 wins & 5 nominations.,1,3,5,9
4846,House Party 3,,0,0,0,0
4847,Somos guerreros,,0,0,0,0
4848,Blown Away,2 nominations.,0,0,2,2
4849,War of the Buttons,2 nominations.,0,0,2,2
4850,Ace Ventura: Pet Detective,5 wins & 5 nominations.,0,5,5,10
4851,To Live,Nominated for 1 Golden Globe. Another 7 wins & 7 nominations.,0,7,8,15
4852,The Getaway,1 win & 3 nominations,0,1,3,4
4853,Death and the Maiden,5 nominations.,0,0,5,5
4854,I Love Trouble,,0,0,0,0
4855,L�on: The Professional,,0,0,0,0
4856,Police Academy: Mission to Moscow,,0,0,0,0
4857,Bullets Over Broadway,Won 1 Oscar. Another 21 wins & 30 nominations.,1,21,30,52
4858,Cabin Boy,2 nominations.,0,0,2,2
4859,Ex�tica,,0,0,0,0
4860,Death Wish V: The Face of Death,,0,0,0,0
4861,Four Weddings and a Funeral,Nominated for 2 Oscars. Another 24 wins & 26 nominations.,2,24,26,52
4862,Leprechaun 2,1 win.,0,1,0,1
4863,Cemetery Man,9 wins & 11 nominations.,0,9,11,20
4864,North,4 wins & 9 nominations.,0,4,9,13
4865,Ashes of Time,9 wins & 16 nominations.,0,9,16,25
4866,"Corrina, Corrina",3 nominations.,0,0,3,3
4867,The Monster,6 nominations.,0,0,6,6
4868,Beverly Hills Cop III,3 nominations,0,0,3,3
4869,River of Grass,6 nominations,0,0,6,6
4870,Forrest Gump,Won 6 Oscars. Another 44 wins & 75 nominations.,6,44,75,125
4871,A Troll in Central Park,,0,0,0,0
4872,I Like It Like That,1 win & 5 nominations.,0,1,5,6
4873,Timecop: Polic�a del futuro,,0,0,0,0
4874,In the Mouth of Madness,1 win & 4 nominations.,0,1,4,5
4875,Exit to Eden,1 win & 4 nominations.,0,1,4,5
4876,Barcelona,1 win & 1 nomination.,0,1,1,2
4877,What's Love Got to Do with It,Nominated for 2 Oscars. Another 3 wins & 13 nominations.,2,3,13,18
4878,Un d�a de furia,,0,0,0,0
4879,Rising Sun,1 win & 1 nomination.,0,1,1,2
4880,Ruby in Paradise,3 wins & 7 nominations.,0,3,7,10
4881,Groundhog Day,Won 1 BAFTA Film Award. Another 6 wins & 17 nominations.,0,7,17,24
4882,The Real McCoy,,0,0,0,0
4883,Jack the Bear,1 win & 3 nominations.,0,1,3,4
4884,Sankofa,1 nomination.,0,0,1,1
4885,Schindler's List,Won 7 Oscars. Another 85 wins & 49 nominations.,7,85,49,141
4886,The Program,,0,0,0,0
4887,Calendar Girl,,0,0,0,0
4888,The Sandlot,1 nomination,0,0,1,1
4889,Matinee,1 win.,0,1,0,1
4890,Last Action Hero,1 win & 16 nominations,0,1,16,17
4891,Addams Family Values,Nominated for 1 Oscar. Another 3 wins & 15 nominations.,1,3,15,19
4892,Rudy,2 wins & 1 nomination.,0,2,1,3
4893,Beethoven's 2nd,Nominated for 1 Oscar. Another 4 nominations.,1,0,4,5
4894,What's Eating Gilbert Grape,Nominated for 1 Oscar. Another 8 wins & 6 nominations.,1,8,6,15
4895,Gettysburg,1 win & 1 nomination.,0,1,1,2
4896,Indian Summer,,0,0,0,0
4897,Mother's Boys,1 nomination.,0,0,1,1
4898,The Saint of Fort Washington,1 win & 2 nominations.,0,1,2,3
4899,We're Back! A Dinosaur's Story,,0,0,0,0
4900,Shadowlands,Nominated for 2 Oscars. Another 7 wins & 12 nominations.,2,7,12,21
4901,The Remains of the Day,Nominated for 8 Oscars. Another 17 wins & 33 nominations.,8,17,33,58
4902,Life with Mikey,2 wins & 2 nominations.,0,2,2,4
4903,CB4,,0,0,0,0
4904,The Firm,Nominated for 2 Oscars. Another 3 wins & 5 nominations.,2,3,5,10
4905,The Crush,2 wins & 3 nominations.,0,2,3,5
4906,Weekend at Bernie's II,1 win & 1 nomination.,0,1,1,2
4907,Undercover Blues,,0,0,0,0
4908,Hocus Pocus,2 wins & 11 nominations.,0,2,11,13
4909,Menace II Society,2 wins & 4 nominations.,0,2,4,6
4910,Iron Monkey,2 nominations.,0,0,2,2
4911,The Fugitive,Won 1 Oscar. Another 12 wins & 37 nominations.,1,12,37,50
4912,RoboCop 3,3 nominations.,0,0,3,3
4913,Man's Best Friend,1 win & 5 nominations.,0,1,5,6
4914,A Home of Our Own,1 win & 3 nominations.,0,1,3,4
4915,El cuerpo del delito,,0,0,0,0
4916,Red Rock West,3 nominations.,0,0,3,3
4917,Gunmen,,0,0,0,0
4918,The Secret Garden,Nominated for 1 BAFTA Film Award. Another 3 wins & 5 nominations.,0,3,6,9
4919,Carlito's Way,2 wins & 9 nominations.,0,2,9,11
4920,Dragon: The Bruce Lee Story,1 win & 3 nominations.,0,1,3,4
4921,The Good Son,1 win & 2 nominations.,0,1,2,3
4922,Alive,Nominated for 1 Primetime Emmy. Another 1 win & 1 nomination.,0,1,2,3
4923,El cielo y la tierra,,0,0,0,0
4924,Leprechaun,1 win & 1 nomination.,0,1,1,2
4925,Searching for Bobby Fischer,Nominated for 1 Oscar. 5 wins & 10 nominations total,1,5,10,16
4926,Money for Nothing,,0,0,0,0
4927,El papalote azul,,0,0,0,0
4928,Return of the Living Dead III,3 wins & 1 nomination,0,3,1,4
4929,Hexed,,0,0,0,0
4930,Rookie of the Year,1 win & 1 nomination.,0,1,1,2
4931,Mi vida loca,,0,0,0,0
4932,In the Line of Fire,Nominated for 3 Oscars. Another 2 wins & 14 nominations.,3,2,14,19
4933,Romeo Is Bleeding,2 nominations.,0,0,2,2
4934,Ghost in the Machine,,0,0,0,0
4935,Carnosaur,,0,0,0,0
4936,Robin Hood: Men in Tights,1 nomination.,0,0,1,1
4937,Indecent Proposal,7 wins & 8 nominations,0,7,8,15
4938,The Scent of Green Papaya,Nominated for 1 Oscar. Another 4 wins & 2 nominations.,1,4,2,7
4939,Batman: Mask of the Phantasm,1 nomination.,0,0,1,1
4940,Manhattan Murder Mystery,Nominated for 1 Golden Globe. Another 3 nominations.,0,0,4,4
4941,Airborne,,0,0,0,0
4942,Untamed Heart,2 wins & 1 nomination.,0,2,1,3
4943,The Cement Garden,2 wins & 3 nominations.,0,2,3,5
4944,Guilty as Sin,1 win.,0,1,0,1
4945,El piano,,0,0,0,0
4946,The Dark Half,4 wins & 11 nominations.,0,4,11,15
4947,Grumpy Old Men,1 win & 1 nomination,0,1,1,2
4948,En el nombre del padre,,0,0,0,0
4949,Son of the Pink Panther,3 nominations.,0,0,3,3
4950,Aspen Extreme,,0,0,0,0
4951,Blue,Won 1 Oscar. Another 55 wins & 81 nominations.,1,55,81,137
4952,Point of No Return,,0,0,0,0
4953,Poetic Justice,Nominated for 1 Oscar. Another 4 wins & 4 nominations.,1,4,4,9
4954,Freaked,2 wins & 9 nominations.,0,2,9,11
4955,Wilder Napalm,,0,0,0,0
4956,Sommersby,2 wins.,0,2,0,2
4957,Son in Law,1 nomination.,0,0,1,1
4958,Judgment Night,,0,0,0,0
4959,Tombstone,2 nominations.,0,0,2,2
4960,The Joy Luck Club,Nominated for 1 BAFTA Film Award. Another 4 wins & 4 nominations.,0,4,5,9
4961,Crime Story,2 wins & 8 nominations.,0,2,8,10
4962,The Meteor Man,1 nomination.,0,0,1,1
4963,"Blood In, Blood Out",1 win & 1 nomination.,0,1,1,2
4964,Blink,2 nominations.,0,0,2,2
4965,The Vanishing,7 wins & 6 nominations.,0,7,6,13
4966,For the Moment,2 wins & 2 nominations.,0,2,2,4
4967,Philadelphia Experiment II,,0,0,0,0
4968,Free Willy,7 wins & 2 nominations.,0,7,2,9
4969,M. Butterfly,1 win & 1 nomination.,0,1,1,2
4970,Philadelphia,Won 2 Oscars. 20 wins & 23 nominations total,2,20,23,45
4971,Josh and S.A.M.,,0,0,0,0
4972,Body Snatchers,6 nominations.,0,0,6,6
4973,Needful Things,1 win & 6 nominations.,0,1,6,7
4974,Sleepless in Seattle,Nominated for 2 Oscars. 4 wins & 19 nominations total,2,4,19,25
4975,Sliver,4 wins & 9 nominations.,0,4,9,13
4976,Best of the Best II,,0,0,0,0
4977,Cool Runnings,2 wins & 2 nominations,0,2,2,4
4978,"Bodies, Rest & Motion",1 win & 1 nomination.,0,1,1,2
4979,Warlock: The Armageddon,2 nominations.,0,0,2,2
4980,So I Married an Axe Murderer,,0,0,0,0
4981,Hot Shots! Part Deux,1 win.,0,1,0,1
4982,Maadadayo,,0,0,0,0
4983,Teenage Mutant Ninja Turtles III,1 win.,0,1,0,1
4984,Posse,1 nomination.,0,0,1,1
4985,Amos & Andrew,Nominated for 3 Golden Globes. Another 4 nominations.,0,0,7,7
4986,Sniper,,0,0,0,0
4987,Loaded Weapon 1,,0,0,0,0
4988,A Perfect World,1 win & 1 nomination.,0,1,1,2
4989,Swing Kids,1 win & 1 nomination.,0,1,1,2
4990,For Love or Money,,0,0,0,0
4991,Totally F***ed Up,,0,0,0,0
4992,Heart and Souls,1 win & 10 nominations.,0,1,10,11
4993,Only the Strong,,0,0,0,0
4994,Wrestling Ernest Hemingway,,0,0,0,0
4995,Fear of a Black Hat,1 nomination,0,0,1,1
4996,Strawberry and Chocolate,Nominated for 1 Oscar. Another 25 wins & 1 nomination.,1,25,1,27
4997,The Man Without a Face,3 nominations.,0,0,3,3
4998,Witchboard 2,,0,0,0,0
4999,Dazed and Confused,1 win & 4 nominations.,0,1,4,5
5000,Father Hood,,0,0,0,0
5001,Kalifornia,4 wins & 4 nominations.,0,4,4,8
5002,Los visitantes,1 nomination.,0,0,1,1
5003,Kika,5 wins & 9 nominations,0,5,9,14
5004,Dave,Nominated for 1 Oscar. Another 2 wins & 5 nominations.,1,2,5,8
5005,Dangerous Game,1 win & 1 nomination.,0,1,1,2
5006,Lost in Yonkers,1 nomination.,0,0,1,1
5007,Another Stakeout,1 nomination.,0,0,1,1
5008,Love & Human Remains,2 wins & 1 nomination.,0,2,1,3
5009,Striking Distance,,0,0,0,0
5010,Fatal Instinct,,0,0,0,0
5011,"Faraway, So Close!",1 nomination.,0,0,1,1
5012,Cronos,23 wins & 13 nominations,0,23,13,36
5013,Nowhere to Run,1 nomination.,0,0,1,1
5014,Look Who's Talking Now,1 win & 4 nominations.,0,1,4,5
5015,Jurassic Park,Won 3 Oscars. Another 42 wins & 27 nominations.,3,42,27,72
5016,Three of Hearts,,0,0,0,0
5017,Arizona Dream,4 wins & 2 nominations.,0,4,2,6
5018,Surf Ninjas,1 nomination.,0,0,1,1
5019,Killing Zoe,2 wins & 1 nomination.,0,2,1,3
5020,Super Mario Bros.,2 nominations,0,0,2,2
5021,The Wedding Banquet,,0,0,0,0
5022,Farewell My Concubine,Nominated for 2 Oscars. Another 25 wins & 10 nominations.,2,25,10,37
5023,Three Colors: Blue,Nominated for 3 Golden Globes. Another 21 wins & 15 nominations.,0,21,18,39
5024,Splitting Heirs,1 nomination.,0,0,1,1
5025,Once Upon a Forest,1 win & 1 nomination.,0,1,1,2
5026,Once Upon a Time in China III,1 win & 1 nomination.,0,1,1,2
5027,Sugar Hill,,0,0,0,0
5028,A Bronx Tale,1 win & 3 nominations,0,1,3,4
5029,This Boy's Life,2 wins & 2 nominations.,0,2,2,4
5030,The Thing Called Love,,0,0,0,0
5031,Cop & �,,0,0,0,0
5032,Even Cowgirls Get the Blues,4 nominations.,0,0,4,4
5033,Fire in the Sky,4 nominations.,0,0,4,4
5034,Wayne's World 2,3 nominations.,0,0,3,3
5035,True Romance,1 win & 10 nominations.,0,1,10,11
5036,Boxing Helena,1 win & 2 nominations.,0,1,2,3
5037,Who's the Man?,,0,0,0,0
5038,Little Buddha,2 wins & 3 nominations,0,2,3,5
5039,The Ballad of Little Jo,2 nominations.,0,0,2,2
5040,My Boyfriend's Back,,0,0,0,0
5041,Benny & Joon,,0,0,0,0
5042,Silent Tongue,1 nomination.,0,0,1,1
5043,My Life,,0,0,0,0
5044,The Nutcracker,,0,0,0,0
5045,Watch It,,0,0,0,0
5046,Born Yesterday,Won 1 Oscar. 5 wins & 10 nominations total,1,5,10,16
5047,Ethan Frome,,0,0,0,0
5048,Short Cuts,Nominated for 1 Oscar. Another 17 wins & 18 nominations.,1,17,18,36
5049,Cliffhanger,Nominated for 3 Oscars. Another 1 win & 9 nominations.,3,1,9,13
5050,A Far Off Place,,0,0,0,0
5051,The Beverly Hillbillies,1 win & 1 nomination.,0,1,1,2
5052,Mrs. Doubtfire,Won 1 Oscar. Another 10 wins & 10 nominations.,1,10,10,21
5053,Raining Stones,9 wins & 4 nominations.,0,9,4,13
5054,Mr. Wonderful,,0,0,0,0
5055,La casa de los esp�ritus,,0,0,0,0
5056,Germinal,2 wins & 11 nominations.,0,2,11,13
5057,Geronimo: An American Legend,Nominated for 1 Oscar. Another 1 win & 1 nomination.,1,1,1,3
5058,The Slingshot,1 win & 4 nominations.,0,1,4,5
5059,Jason Goes to Hell: The Final Friday,5 nominations.,0,0,5,5
5060,Mr. Nanny,2 nominations.,0,0,2,2
5061,Homeward Bound: The Incredible Journey,1 nomination,0,0,1,1
5062,Mr. Jones,4 wins & 12 nominations.,0,4,12,16
5063,The Pelican Brief,1 win & 2 nominations.,0,1,2,3
5064,A Dangerous Woman,1 win & 4 nominations.,0,1,4,5
5065,Wide Sargasso Sea,,0,0,0,0
5066,Made in America,1 win & 1 nomination.,0,1,1,2
5067,Hard Target,1 win & 5 nominations.,0,1,5,6
5068,The Advocate,,0,0,0,0
5069,Dennis the Menace,3 wins & 3 nominations.,0,3,3,6
5070,The Temp,1 win & 1 nomination.,0,1,1,2
5071,Mad Dog and Glory,2 nominations.,0,0,2,2
5072,Naked,8 wins & 7 nominations.,0,8,7,15
5073,Six Degrees of Separation,Nominated for 1 Oscar. Another 5 nominations.,1,0,5,6
5074,The Adventures of Huck Finn,,0,0,0,0
5075,Demolition Man,1 win & 7 nominations.,0,1,7,8
5076,The Nightmare Before Christmas,Nominated for 1 Oscar. Another 7 wins & 16 nominations.,1,7,16,24
5077,Coneheads,2 nominations.,0,0,2,2
5078,The Age of Innocence,Won 1 Oscar. Another 14 wins & 33 nominations.,1,14,33,48
5079,Sister Act 2: Back in the Habit,1 win & 3 nominations.,0,1,3,4
5080,Naked in New York,1 win & 1 nomination.,0,1,1,2
5081,The Thief and the Cobbler,,0,0,0,0
5082,Sirenas,,0,0,0,0
5083,White Sands,,0,0,0,0
5084,A Tale of Winter,2 wins & 2 nominations.,0,2,2,4
5085,Brain Donors,,0,0,0,0
5086,Toys,Nominated for 2 Oscars. Another 10 nominations.,2,0,10,12
5087,Alien 3,,0,0,0,0
5088,B�b�'s Kids,,0,0,0,0
5089,Batman Returns,Nominated for 2 Oscars. Another 2 wins & 27 nominations.,2,2,27,31
5090,Unforgiven,Won 4 Oscars. 50 wins & 47 nominations total,4,50,47,101
5091,3 Ninjas,1 nomination.,0,0,1,1
5092,Bram Stoker's Dracula,,0,0,0,0
5093,Beethoven,1 win & 4 nominations.,0,1,4,5
5094,Bob Roberts,Nominated for 1 Golden Globe. Another 4 wins & 2 nominations.,0,4,3,7
5095,The Mighty Ducks,2 nominations.,0,0,2,2
5096,Universal Soldier,,0,0,0,0
5097,The Tom and Jerry Movie,,0,0,0,0
5098,Unlawful Entry,1 nomination.,0,0,1,1
5099,Bajos instintos,,0,0,0,0
5100,The Gun in Betty Lou's Handbag,,0,0,0,0
5101,A Stranger Among Us,1 win & 3 nominations.,0,1,3,4
5102,Big Girls Don't Cry... They Get Even,,0,0,0,0
5103,A Midnight Clear,1 nomination.,0,0,1,1
5104,Year of the Comet,,0,0,0,0
5105,The Mambo Kings,Nominated for 1 Oscar. Another 5 nominations.,1,0,5,6
5106,The Long Day Closes,2 wins & 1 nomination.,0,2,1,3
5107,The Power of One,1 win & 4 nominations.,0,1,4,5
5108,The Hand That Rocks the Cradle,6 wins & 6 nominations.,0,6,6,12
5109,The Living End,1 nomination.,0,0,1,1
5110,The Muppet Christmas Carol,2 wins & 1 nomination.,0,2,1,3
5111,Traces of Red,1 nomination.,0,0,1,1
5112,1492: Conquista del Para�so,,0,0,0,0
5113,This Is My Life,3 nominations.,0,0,3,3
5114,The Last of the Mohicans,Won 1 Oscar. Another 6 wins & 17 nominations.,1,6,17,24
5115,Wayne's World,4 wins & 5 nominations.,0,4,5,9
5116,Thunderheart,2 nominations.,0,0,2,2
5117,Twin Peaks: Fire Walk with Me,4 wins & 7 nominations.,0,4,7,11
5118,Used People,Nominated for 2 Golden Globes. Another 2 nominations.,0,0,4,4
5119,The Public Eye,,0,0,0,0
5120,The Player,Nominated for 3 Oscars. Another 24 wins & 30 nominations.,3,24,30,57
5121,White Men Can't Jump,4 nominations.,0,0,4,4
5122,A League of Their Own,6 wins & 13 nominations.,0,6,13,19
5123,Under Siege,Nominated for 2 Oscars. Another 3 wins & 1 nomination.,2,3,1,6
5124,Army of Darkness,12 wins & 7 nominations.,0,12,7,19
5125,Whispers in the Dark,1 nomination.,0,0,1,1
5126,Tokyo Decadence,1 win.,0,1,0,1
5127,Article 99,,0,0,0,0
5128,American Heart,1 win & 4 nominations.,0,1,4,5
5129,American Me,1 nomination.,0,0,1,1
5130,Aladdin,Won 2 Oscars. Another 31 wins & 22 nominations.,2,31,22,55
5131,A River Runs Through It,Won 1 Oscar. Another 3 wins & 11 nominations.,1,3,11,15
5132,Wind,,0,0,0,0
5133,The Waterdance,5 wins & 5 nominations.,0,5,5,10
5134,Un Coeur en Hiver,Nominated for 1 BAFTA Film Award. Another 16 wins & 12 nominations.,0,16,13,29
5135,A Few Good Men,Nominated for 4 Oscars. Another 10 wins & 26 nominations.,4,10,26,40
5136,The Lawnmower Man,3 nominations.,0,0,3,3
5137,A Place in the World,Nominated for 1 Oscar. Another 16 wins & 6 nominations.,1,16,6,23
5138,Bad Lieutenant,2 wins & 5 nominations.,0,2,5,7
5139,Boomerang,1 win & 5 nominations,0,1,5,6
5140,Twin Dragons,1 nomination.,0,0,1,1
5141,The Opposite Sex and How to Live with Them,,0,0,0,0
5142,Belle Epoque,Won 1 Oscar. Another 24 wins & 15 nominations.,1,24,15,40
5143,Waterland,1 win & 1 nomination.,0,1,1,2
5144,The Stolen Children,18 wins & 14 nominations.,0,18,14,32
5145,The Story of Qiu Ju,20 wins & 10 nominations.,0,20,10,30
5146,Zebrahead,2 wins & 5 nominations.,0,2,5,7
5147,Aces: Iron Eagle III,,0,0,0,0
5148,Blame It on the Bellboy,,0,0,0,0
5149,The Playboys,1 win.,0,1,0,1
5150,The Lover,Nominated for 1 Oscar. Another 3 wins & 6 nominations.,1,3,6,10
5151,Innocent Blood,6 nominations.,0,0,6,6
5152,Leap of Faith,,0,0,0,0
5153,FernGully: Las aventuras de Zak y Crysta,,0,0,0,0
5154,Sister Act,9 wins & 10 nominations,0,9,10,19
5155,Encino Man,1 win & 1 nomination.,0,1,1,2
5156,Glengarry Glen Ross,Nominated for 1 Oscar. Another 8 wins & 12 nominations.,1,8,12,21
5157,Raising Cain,5 nominations.,0,0,5,5
5158,Lethal Weapon 3,3 wins & 4 nominations,0,3,4,7
5159,City of Joy,1 nomination.,0,0,1,1
5160,Claire of the Moon,,0,0,0,0
5161,Mistress,,0,0,0,0
5162,Noises Off...,1 win.,0,1,0,1
5163,Radio Flyer,1 win & 2 nominations.,0,1,2,3
5164,Passed Away,1 nomination.,0,0,1,1
5165,The Bodyguard,Nominated for 2 Oscars. Another 10 wins & 19 nominations.,2,10,19,31
5166,Light Sleeper,1 win & 6 nominations.,0,1,6,7
5167,Forever Young,,0,0,0,0
5168,Leaving Normal,,0,0,0,0
5169,Singles,1 win & 3 nominations.,0,1,3,4
5170,Pushing Hands,6 wins & 8 nominations.,0,6,8,14
5171,Cool World,2 nominations,0,0,2,2
5172,Hoffa,Nominated for 2 Oscars. Another 2 wins & 4 nominations.,2,2,4,8
5173,Como agua para chocolate,Nominated for 1 Golden Globe. Another 26 wins & 12 nominations.,0,26,13,39
5174,Ladybugs,3 nominations.,0,0,3,3
5175,Sidekicks,,0,0,0,0
5176,Rebels of the Neon God,5 wins & 5 nominations.,0,5,5,10
5177,Mom and Dad Save the World,1 nomination.,0,0,1,1
5178,Simple Men,2 nominations.,0,0,2,2
5179,Children of the Corn II: The Final Sacrifice,1 nomination.,0,0,1,1
5180,Storyville,1 nomination.,0,0,1,1
5181,Rapid Fire,,0,0,0,0
5182,Laws of Gravity,3 wins & 7 nominations.,0,3,7,10
5183,Single White Female,1 win & 1 nomination.,0,1,1,2
5184,Mo' Money,1 win.,0,1,0,1
5185,Christopher Columbus: The Discovery,2 wins & 6 nominations.,0,2,6,8
5186,Hellraiser III: Hell on Earth,1 win & 10 nominations.,0,1,10,11
5187,Class Act,,0,0,0,0
5188,Mac,1 win & 2 nominations.,0,1,2,3
5189,"Olivier, Olivier",2 wins & 3 nominations.,0,2,3,5
5190,Love Field,Nominated for 1 Oscar. Another 1 win & 3 nominations.,1,1,3,5
5191,Love Potion No. 9,,0,0,0,0
5192,Far and Away,3 nominations,0,0,3,3
5193,South Central,3 nominations.,0,0,3,3
5194,Memoirs of an Invisible Man,5 nominations.,0,0,5,5
5195,Once Upon a Crime...,1 nomination.,0,0,1,1
5196,Prelude to a Kiss,,0,0,0,0
5197,One False Move,8 wins & 8 nominations.,0,8,8,16
5198,Poison Ivy,2 nominations.,0,0,2,2
5199,Death Becomes Her,Won 1 Oscar. Another 4 wins & 16 nominations.,1,4,16,21
5200,The Babe,1 nomination.,0,0,1,1
5201,Pet Sematary II,3 nominations.,0,0,3,3
5202,Peter's Friends,4 wins & 3 nominations.,0,4,3,7
5203,Luna amarga,,0,0,0,0
5204,L�olo,,0,0,0,0
5205,Love Crimes,1 nomination.,0,0,1,1
5206,Deep Cover,4 nominations.,0,0,4,4
5207,Man Trouble,1 nomination.,0,0,1,1
5208,Crossing the Bridge,,0,0,0,0
5209,Sleepwalkers,5 wins.,0,5,0,5
5210,Pure Country,,0,0,0,0
5211,Split Second,,0,0,0,0
5212,Stop! Or My Mom Will Shoot,3 wins & 1 nomination.,0,3,1,4
5213,Man Bites Dog,6 wins & 5 nominations.,0,6,5,11
5214,Passenger 57,,0,0,0,0
5215,For a Lost Soldier,1 win.,0,1,0,1
5216,Passion Fish,Nominated for 2 Oscars. Another 2 wins & 9 nominations.,2,2,9,13
5217,Malcolm X,Nominated for 2 Oscars. Another 19 wins & 22 nominations.,2,19,22,43
5218,Patriot Games,1 win & 3 nominations,0,1,3,4
5219,Sneakers,2 nominations,0,0,2,2
5220,Folks!,1 nomination.,0,0,1,1
5221,The Best Intentions,4 wins & 7 nominations.,0,4,7,11
5222,Lorenzo's Oil,Nominated for 2 Oscars. Another 6 nominations.,2,0,6,8
5223,Of Mice and Men,1 nomination.,0,0,1,1
5224,Fifty/Fifty,,0,0,0,0
5225,Hold Me Thrill Me Kiss Me,1 win & 1 nomination.,0,1,1,2
5226,CrissCross,,0,0,0,0
5227,Ruby,,0,0,0,0
5228,Dead Alive,14 wins & 7 nominations.,0,14,7,21
5229,The Efficiency Expert,3 wins & 7 nominations.,0,3,7,10
5230,Consenting Adults,1 nomination.,0,0,1,1
5231,Orlando,Nominated for 2 Oscars. Another 15 wins & 9 nominations.,2,15,9,26
5232,Captain Ron,2 nominations.,0,0,2,2
5233,Nemesis,,0,0,0,0
5234,That Night,,0,0,0,0
5235,"Gas, Food Lodging",4 wins & 6 nominations.,0,4,6,10
5236,Juego a muerte,,0,0,0,0
5237,Juice,1 nomination.,0,0,1,1
5238,Final Analysis,1 win & 4 nominations.,0,1,4,5
5239,Just Another Girl on the I.R.T.,2 wins & 3 nominations.,0,2,3,5
5240,Husbands and Wives,Nominated for 2 Oscars. Another 12 wins & 15 nominations.,2,12,15,29
5241,Newsies,1 win & 6 nominations.,0,1,6,7
5242,Ruby Cairo,,0,0,0,0
5243,My Cousin Vinny,Won 1 Oscar. Another 4 wins & 6 nominations.,1,4,6,11
5244,Medicine Man,1 nomination.,0,0,1,1
5245,Candyman,5 wins & 10 nominations.,0,5,10,15
5246,Savage Nights,7 wins & 5 nominations.,0,7,5,12
5247,Indochine,Won 1 Oscar. Another 11 wins & 13 nominations.,1,11,13,25
5248,Naked Killer,1 nomination.,0,0,1,1
5249,Dr. Giggles,1 win & 2 nominations.,0,1,2,3
5250,In the Soup,5 wins & 3 nominations.,0,5,3,8
5251,Into the Sun,,0,0,0,0
5252,My New Gun,1 nomination.,0,0,1,1
5253,Scent of a Woman,Won 1 Oscar. 6 wins & 14 nominations total,1,6,14,21
5254,Jennifer 8,5 wins.,0,5,0,5
5255,Sarafina!,3 nominations.,0,0,3,3
5256,Supercop,2 wins & 4 nominations.,0,2,4,6
5257,"Jam�n, Jam�n",,0,0,0,0
5258,School Ties,3 nominations.,0,0,3,3
5259,Out on a Limb,1 win.,0,1,0,1
5260,Tetsuo II: Body Hammer,3 wins & 2 nominations.,0,3,2,5
5261,Reservoir Dogs,12 wins & 23 nominations.,0,12,23,35
5262,Guncrazy,Nominated for 1 Golden Globe. Another 1 win & 1 nomination.,0,1,2,3
5263,Mr. Saturday Night,Nominated for 1 Oscar. Another 7 nominations.,1,0,7,8
5264,The Distinguished Gentleman,4 wins,0,4,0,4
5265,Roadside Prophets,,0,0,0,0
5266,The Crying Game,Won 1 Oscar. Another 21 wins & 46 nominations.,1,21,46,68
5267,Shining Through,5 wins & 2 nominations,0,5,2,7
5268,Kuffs,1 win & 1 nomination.,0,1,1,2
5269,No Place to Hide,,0,0,0,0
5270,Chaplin,Nominated for 3 Oscars. Another 3 wins & 16 nominations.,3,3,16,22
5271,Damage,Nominated for 1 Oscar. Another 6 wins & 4 nominations.,1,6,4,11
5272,Honeymoon in Vegas,Nominated for 2 Golden Globes. Another 2 nominations.,0,0,4,4
5273,Rich in Love,,0,0,0,0
5274,Fortress,2 nominations.,0,0,2,2
5275,Diggstown,,0,0,0,0
5276,Honey I Blew Up the Kid,10 nominations,0,0,10,10
5277,Straight Talk,,0,0,0,0
5278,Home Alone 2: Lost in New York,3 wins & 3 nominations.,0,3,3,6
5279,El Mariachi,7 wins & 4 nominations.,0,7,4,11
5280,Stay Tuned,2 nominations.,0,0,2,2
5281,Freddie as F.R.O.7.,,0,0,0,0
5282,House of Angels,7 wins & 3 nominations.,0,7,3,10
5283,Howards End,Won 3 Oscars. Another 29 wins & 49 nominations.,3,29,49,81
5284,Map of the Human Heart,3 wins & 8 nominations.,0,3,8,11
5285,The Cutting Edge,,0,0,0,0
5286,Swoon,6 wins & 6 nominations.,0,6,6,12
5287,Romper Stomper,8 wins & 7 nominations.,0,8,7,15
5288,Strictly Ballroom,Won 3 BAFTA Film Awards. Another 16 wins & 18 nominations.,0,19,18,37
5289,Chain of Desire,1 nomination.,0,0,1,1
5290,Mr. Baseball,1 nomination.,0,0,1,1
5291,Khuda Gawah,4 wins & 6 nominations.,0,4,6,10
5292,Night and the City,,0,0,0,0
5293,HouseSitter,,0,0,0,0
5294,Freejack,3 nominations.,0,0,3,3
5295,Shadow of the Wolf,2 wins & 2 nominations.,0,2,2,4
5296,Daughters of the Dust,4 wins & 2 nominations.,0,4,2,6
5297,Only Yesterday,,0,0,0,0
5298,Only the Lonely,,0,0,0,0
5299,Star Trek VI: The Undiscovered Country,Nominated for 2 Oscars. Another 2 wins & 7 nominations.,2,2,7,11
5300,Flight of the Intruder,,0,0,0,0
5301,Cabeza de Vaca,2 wins & 5 nominations.,0,2,5,7
5302,One Good Cop,1 nomination.,0,0,1,1
5303,And You Thought Your Parents Were Weird,4 nominations.,0,0,4,4
5304,Naked Lunch,13 wins & 18 nominations.,0,13,18,31
5305,Toy Soldiers,1 nomination.,0,0,1,1
5306,Amigos inseparables,,0,0,0,0
5307,Tous les matins du monde,9 wins & 8 nominations,0,9,8,17
5308,Toto the Hero,Nominated for 1 BAFTA Film Award. Another 16 wins & 3 nominations.,0,16,4,20
5309,Necessary Roughness,,0,0,0,0
5310,Curly Sue,1 win.,0,1,0,1
5311,Fried Green Tomatoes,Nominated for 2 Oscars. Another 6 wins & 12 nominations.,2,6,12,20
5312,Suburban Commando,,0,0,0,0
5313,New Jack City,1 win & 5 nominations.,0,1,5,6
5314,Strictly Business,,0,0,0,0
5315,Night on Earth,1 win & 2 nominations.,0,1,2,3
5316,Freddy's Dead: The Final Nightmare,1 win & 4 nominations.,0,1,4,5
5317,Frankie and Johnny,Nominated for 1 Golden Globe. Another 4 wins & 1 nomination.,0,4,2,6
5318,Timebomb,1 win.,0,1,0,1
5319,Straight Out of Brooklyn,4 wins & 5 nominations.,0,4,5,9
5320,Bingo,2 nominations.,0,0,2,2
5321,An American Tail: Fievel Goes West,,0,0,0,0
5322,For the Boys,Nominated for 1 Oscar. Another 1 win & 2 nominations.,1,1,2,4
5323,Not Without My Daughter,2 wins & 1 nomination.,0,2,1,3
5324,Billy Bathgate,Nominated for 1 Golden Globe. Another 2 nominations.,0,0,3,3
5325,Stone Cold,1 nomination.,0,0,1,1
5326,Stepping Out,,0,0,0,0
5327,Nothing But Trouble,2 wins & 6 nominations.,0,2,6,8
5328,Bill & Ted's Bogus Journey,,0,0,0,0
5329,Thousand Pieces of Gold,1 win & 1 nomination.,0,1,1,2
5330,Flirting,5 wins & 3 nominations.,0,5,3,8
5331,Once Around,1 nomination.,0,0,1,1
5332,The Lovers on the Bridge,Nominated for 1 BAFTA Film Award. Another 5 wins & 10 nominations.,0,5,11,16
5333,Oscar,3 nominations.,0,0,3,3
5334,Problem Child 2,3 nominations.,0,0,3,3
5335,Other People's Money,,0,0,0,0
5336,Dying Young,3 nominations.,0,0,3,3
5337,The Perfect Weapon,,0,0,0,0
5338,Shadows and Fog,1 win & 2 nominations.,0,1,2,3
5339,Shakes the Clown,1 nomination.,0,0,1,1
5340,The Rocketeer,1 win & 6 nominations.,0,1,6,7
5341,The People Under the Stairs,2 wins & 7 nominations.,0,2,7,9
5342,Shattered,,0,0,0,0
5343,Dutch,1 win & 1 nomination.,0,1,1,2
5344,Robin Hood: Prince of Thieves,Nominated for 1 Oscar. Another 16 wins & 23 nominations.,1,16,23,40
5345,The Object of Beauty,,0,0,0,0
5346,Riff-Raff,3 wins & 4 nominations.,0,3,4,7
5347,Ricochet,,0,0,0,0
5348,Edward II,5 wins & 2 nominations,0,5,2,7
5349,Return to the Blue Lagoon,6 nominations.,0,0,6,6
5350,Shout,3 nominations.,0,0,3,3
5351,Showdown in Little Tokyo,,0,0,0,0
5352,Regarding Henry,1 win & 2 nominations.,0,1,2,3
5353,Barton Fink,Nominated for 3 Oscars. Another 19 wins & 27 nominations.,3,19,27,49
5354,Sex and Zen,,0,0,0,0
5355,Becoming Colette,,0,0,0,0
5356,Doc Hollywood,,0,0,0,0
5357,Scenes from a Mall,,0,0,0,0
5358,The Prince of Tides,Nominated for 7 Oscars. Another 3 wins & 11 nominations.,7,3,11,21
5359,Beastmaster 2: Through the Portal of Time,,0,0,0,0
5360,Scissors,,0,0,0,0
5361,Double Impact,2 nominations.,0,0,2,2
5362,Samantha,1 win.,0,1,0,1
5363,The Rapture,4 nominations.,0,0,4,4
5364,The Pope Must Diet,1 nomination,0,0,1,1
5365,Don't Tell Mom the Babysitter's Dead,4 nominations.,0,0,4,4
5366,Drop Dead Fred,,0,0,0,0
5367,Run,3 wins & 4 nominations.,0,3,4,7
5368,Beauty and the Beast,Won 2 Oscars. Another 30 wins & 32 nominations.,2,30,32,64
5369,The Pit and the Pendulum,1 win & 5 nominations.,0,1,5,6
5370,Dogfight,1 nomination.,0,0,1,1
5371,The Silence of the Lambs,Won 5 Oscars. Another 64 wins & 51 nominations.,5,64,51,120
5372,Rapsodia en agosto,,0,0,0,0
5373,Thelma & Louise,15 wins & 46 nominations.,0,15,46,61
5374,F/X2,,0,0,0,0
5375,Soapdish,,0,0,0,0
5376,Eve of Destruction,,0,0,0,0
5377,At Play in the Fields of the Lord,Nominated for 1 Golden Globe. Another 1 win & 1 nomination.,0,1,2,3
5378,Deceived,,0,0,0,0
5379,Popcorn,,0,0,0,0
5380,Poison,4 wins & 6 nominations.,0,4,6,10
5381,Armour of God 2: Operation Condor,,0,0,0,0
5382,Enchanted April,Nominated for 3 Oscars. Another 4 wins & 6 nominations.,3,4,6,13
5383,Father of the Bride,1 win & 4 nominations.,0,1,4,5
5384,Paradise,,0,0,0,0
5385,The Marrying Man,1 nomination.,0,0,1,1
5386,Another You,,0,0,0,0
5387,The Man in the Moon,3 nominations.,0,0,3,3
5388,Dead Again,Nominated for 1 Golden Globe. Another 1 win & 4 nominations.,0,1,5,6
5389,Out for Justice,,0,0,0,0
5390,Europa,18 wins & 9 nominations.,0,18,9,27
5391,The Taking of Beverly Hills,,0,0,0,0
5392,Prospero's Books,Nominated for 1 BAFTA Film Award. Another 3 wins & 4 nominations.,0,3,5,8
5393,Backdraft,Nominated for 3 Oscars. Another 1 win & 8 nominations.,3,1,8,12
5394,Rambling Rose,Nominated for 2 Oscars. Another 6 wins & 13 nominations.,2,6,13,21
5395,Raise the Red Lantern,Nominated for 1 Oscar. Another 24 wins & 14 nominations.,1,24,14,39
5396,Slacker,1 win & 3 nominations.,0,1,3,4
5397,Queens Logic,1 nomination.,0,0,1,1
5398,Sleeping with the Enemy,2 wins & 4 nominations.,0,2,4,6
5399,Pure Luck,,0,0,0,0
5400,Punto de quiebra,,0,0,0,0
5401,The Naked Gun 2�: The Smell of Fear,,0,0,0,0
5402,Delirious,,0,0,0,0
5403,Delicatessen,Nominated for 1 BAFTA Film Award. Another 15 wins & 15 nominations.,0,15,16,31
5404,Defenseless,,0,0,0,0
5405,Ernest Scared Stupid,,0,0,0,0
5406,Defending Your Life,5 nominations.,0,0,5,5
5407,The Super,1 win.,0,1,0,1
5408,Mystery Date,,0,0,0,0
5409,Crooked Hearts,,0,0,0,0
5410,Wild Orchid II: Two Shades of Blue,,0,0,0,0
5411,Harley Davidson and the Marlboro Man,1 nomination.,0,0,1,1
5412,Hard Promises,,0,0,0,0
5413,Homicide,3 wins & 7 nominations.,0,3,7,10
5414,Hangin' with the Homeboys,2 wins & 8 nominations.,0,2,8,10
5415,Van Gogh,3 wins & 13 nominations.,0,3,13,16
5416,The Adjuster,5 wins & 2 nominations.,0,5,2,7
5417,The Addams Family,Nominated for 1 Oscar. Another 5 wins & 20 nominations.,1,5,20,26
5418,Mannequin: On the Move,,0,0,0,0
5419,V.I. Warshawski,1 nomination.,0,0,1,1
5420,Company Business,,0,0,0,0
5421,La bella latosa,,0,0,0,0
5422,The Commitments,Nominated for 1 Oscar. Another 11 wins & 12 nominations.,1,11,12,24
5423,Guilty by Suspicion,2 wins & 2 nominations.,0,2,2,4
5424,Body Parts,2 wins & 6 nominations.,0,2,6,8
5425,Whore,,0,0,0,0
5426,Married to It,,0,0,0,0
5427,Until the End of the World,3 wins & 2 nominations.,0,3,2,5
5428,Hook,Nominated for 5 Oscars. Another 7 wins & 17 nominations.,5,7,17,29
5429,L.A. Story,1 nomination,0,0,1,1
5430,McBain,,0,0,0,0
5431,Wild Hearts Can't Be Broken,,0,0,0,0
5432,Cool as Ice,1 win & 7 nominations.,0,1,7,8
5433,Terminator 2: Judgment Day,Won 4 Oscars. Another 32 wins & 33 nominations.,4,32,33,69
5434,The Indian Runner,1 win & 1 nomination.,0,1,1,2
5435,Mediterraneo,Won 1 Oscar. Another 8 wins & 17 nominations.,1,8,17,26
5436,Hot Shots!,1 win.,0,1,0,1
5437,Teenage Mutant Ninja Turtles II: The Secret of the Ooze,2 wins & 1 nomination.,0,2,1,3
5438,Bugsy,Won 2 Oscars. Another 10 wins & 41 nominations.,2,10,41,53
5439,Madame Bovary,2 nominations.,0,0,2,2
5440,White Fang,1 win.,0,1,0,1
5441,House Party 2,,0,0,0,0
5442,Child's Play 3,1 win & 3 nominations.,0,1,3,4
5443,Class Action,1 nomination.,0,0,1,1
5444,Little Man Tate,2 wins & 1 nomination.,0,2,1,3
5445,Livin' Large!,,0,0,0,0
5446,A Rage in Harlem,1 nomination.,0,0,1,1
5447,Life Stinks,,0,0,0,0
5448,London Kills Me,,0,0,0,0
5449,Liebestraum,,0,0,0,0
5450,City of Hope,5 wins & 4 nominations.,0,5,4,9
5451,City Slickers,Won 1 Oscar. Another 7 wins & 7 nominations.,1,7,7,15
5452,What About Bob?,2 wins & 2 nominations.,0,2,2,4
5453,Boyz n the Hood,Nominated for 2 Oscars. Another 12 wins & 21 nominations.,2,12,21,35
5454,The Hitman,,0,0,0,0
5455,Hear My Song,Nominated for 1 Golden Globe. Another 4 wins & 3 nominations.,0,4,4,8
5456,A Kiss Before Dying,2 wins.,0,2,0,2
5457,High Heels,1 win.,0,1,0,1
5458,The Butcher's Wife,1 nomination.,0,0,1,1
5459,Late for Dinner,,0,0,0,0
5460,"He Said, She Said",,0,0,0,0
5461,Where Angels Fear to Tread,1 win.,0,1,0,1
5462,Where the Day Takes You,1 win & 2 nominations.,0,1,2,3
5463,Highlander II: The Quickening,,0,0,0,0
5464,Close My Eyes,4 wins.,0,4,0,4
5465,The Ballad of the Sad Cafe,1 nomination.,0,0,1,1
5466,Highway 61,3 wins & 4 nominations.,0,3,4,7
5467,Closet Land,1 win & 1 nomination.,0,1,1,2
5468,Voyager,4 wins & 4 nominations.,0,4,4,8
5469,Lovers: A True Story,14 wins & 9 nominations.,0,14,9,23
5470,The Inner Circle,12 nominations.,0,0,12,12
5471,The Hard Way,1 nomination.,0,0,1,1
5472,Meeting Venus,3 wins & 2 nominations.,0,3,2,5
5473,If Looks Could Kill,3 nominations.,0,0,3,3
5474,Mobsters,2 nominations.,0,0,2,2
5475,Mon Pere Ce Heros,1 nomination.,0,0,1,1
5476,S�lo con tu pareja,,0,0,0,0
5477,Twenty-One,3 nominations.,0,0,3,3
5478,Mortal Thoughts,1 win & 1 nomination.,0,1,1,2
5479,Johnny Stecchino,5 wins & 3 nominations.,0,5,3,8
5480,Year of the Gun,1 nomination.,0,0,1,1
5481,All I Want for Christmas,3 nominations.,0,0,3,3
5482,The Knife,1 win & 1 nomination.,0,1,1,2
5483,Switch,3 nominations.,0,0,3,3
5484,29th Street,,0,0,0,0
5485,True Identity,,0,0,0,0
5486,Jungle Fever,6 wins & 9 nominations,0,6,9,15
5487,True Colors,,0,0,0,0
5488,The Last Boy Scout,2 nominations.,0,0,2,2
5489,The Five Heartbeats,1 win & 1 nomination.,0,1,1,2
5490,The Fisher King,Won 1 Oscar. Another 13 wins & 38 nominations.,1,13,38,52
5491,The Princess and the Goblin,,0,0,0,0
5492,My Girl,2 wins & 5 nominations.,0,2,5,7
5493,My Heroes Have Always Been Cowboys,1 nomination.,0,0,1,1
5494,JFK,Won 2 Oscars. Another 17 wins & 43 nominations.,2,17,43,62
5495,Impromptu,1 win & 1 nomination.,0,1,1,2
5496,Black Robe,10 wins & 13 nominations.,0,10,13,23
5497,My Own Private Idaho,12 wins & 10 nominations.,0,12,10,22
5498,Mississippi Masala,5 wins & 3 nominations.,0,5,3,8
5499,Cape Fear,Nominated for 2 Oscars. Another 5 wins & 19 nominations.,2,5,19,26
5500,The Double Life of Veronique,11 wins & 12 nominations.,0,11,12,23
5501,Grand Canyon,Nominated for 1 Oscar. Another 3 wins & 6 nominations.,1,3,6,10
5502,Career Opportunities,,0,0,0,0
5503,Talkin' Dirty After Dark,,0,0,0,0
5504,The Doors,3 nominations.,0,0,3,3
5505,Kafka,3 wins & 2 nominations.,0,3,2,5
5506,The Doctor,3 nominations.,0,0,3,3
5507,Under Suspicion,2 nominations.,0,0,2,2
5508,K2,,0,0,0,0
5509,Talent for the Game,,0,0,0,0
5510,Hudson Hawk,3 wins & 5 nominations.,0,3,5,8
5511,King Ralph,,0,0,0,0
5512,Kickboxer 2: The Road Back,,0,0,0,0
5513,RoboCop 2,3 nominations.,0,0,3,3
5514,Hidden Agenda,2 wins & 3 nominations.,0,2,3,5
5515,Jacob's Ladder,3 wins.,0,3,0,3
5516,Leatherface: Texas Chainsaw Massacre III,1 nomination.,0,0,1,1
5517,Henry & June,,0,0,0,0
5518,The Russia House,Nominated for 1 Golden Globe. Another 4 nominations.,0,0,5,5
5519,Kindergarten Cop,4 wins & 1 nomination.,0,4,1,5
5520,Wild at Heart,Nominated for 1 Oscar. Another 5 wins & 11 nominations.,1,5,11,17
5521,Roger Corman's Frankenstein Unbound,4 nominations.,0,0,4,4
5522,Back to the Future Part III,5 wins & 11 nominations.,0,5,11,16
5523,3 Men and a Little Lady,,0,0,0,0
5524,Life Is Sweet,8 wins & 3 nominations.,0,8,3,11
5525,Rocky V,9 nominations.,0,0,9,9
5526,Internal Affairs,,0,0,0,0
5527,Quigley Down Under,2 wins & 1 nomination.,0,2,1,3
5528,"�Ay, Carmela!",22 wins & 6 nominations.,0,22,6,28
5529,Quick Change,,0,0,0,0
5530,House Party,2 wins & 10 nominations.,0,2,10,12
5531,"Welcome Home, Roxy Carmichael",,0,0,0,0
5532,Young Guns II,Nominated for 1 Oscar. Another 3 wins & 3 nominations.,1,3,3,7
5533,"I, the Worst of All",4 wins & 1 nomination.,0,4,1,5
5534,A Cry in the Wild,1 nomination.,0,0,1,1
5535,El pr�ncipe Cascanueces,,0,0,0,0
5536,I Love You to Death,,0,0,0,0
5537,The Rescuers Down Under,6 wins.,0,6,0,6
5538,Edward Scissorhands,Nominated for 1 Oscar. Another 9 wins & 23 nominations.,1,9,23,33
5539,Reversal of Fortune,Won 1 Oscar. Another 12 wins & 16 nominations.,1,12,16,29
5540,White Palace,Nominated for 1 Golden Globe. Another 1 win.,0,1,1,2
5541,Home Alone,Nominated for 2 Oscars. Another 11 wins & 4 nominations.,2,11,4,17
5542,Journey of Hope,Won 1 Oscar. Another 3 wins & 2 nominations.,1,3,2,6
5543,Repossessed,1 win.,0,1,0,1
5544,White Hunter Black Heart,2 nominations.,0,0,2,2
5545,DuckTales the Movie: Treasure of the Lost Lamp,1 nomination.,0,0,1,1
5546,The Return of Superfly,,0,0,0,0
5547,Rosencrantz & Guildenstern Are Dead,3 wins & 2 nominations.,0,3,2,5
5548,Bad Influence,1 win & 1 nomination.,0,1,1,2
5549,El vengador del futuro,,0,0,0,0
5550,Joe Versus the Volcano,1 nomination.,0,0,1,1
5551,El verdugo de Nueva York,,0,0,0,0
5552,The Sheltering Sky,Won 1 Golden Globe. Another 8 wins & 8 nominations.,0,9,8,17
5553,Lambada,,0,0,0,0
5554,Jetsons: The Movie,1 nomination.,0,0,1,1
5555,Dreams,3 wins & 12 nominations.,0,3,12,15
5556,The Shrimp on the Barbie,,0,0,0,0
5557,Ju Dou,Nominated for 1 Oscar. Another 10 wins & 2 nominations.,1,10,2,13
5558,Funny About Love,,0,0,0,0
5559,Pretty Woman,Nominated for 1 Oscar. Another 8 wins & 10 nominations.,1,8,10,19
5560,Q & A,,0,0,0,0
5561,Mermaids,Nominated for 1 Golden Globe. Another 4 wins.,0,4,1,5
5562,Ultra Warrior,,0,0,0,0
5563,Misery,Won 1 Oscar. Another 4 wins & 10 nominations.,1,4,10,15
5564,Mindwalk,1 nomination.,0,0,1,1
5565,Alice,Nominated for 1 Oscar. Another 1 win & 6 nominations.,1,1,6,8
5566,Miller's Crossing,4 wins & 16 nominations.,0,4,16,20
5567,Miami Blues,2 wins & 2 nominations.,0,2,2,4
5568,Goodfellas,Won 1 Oscar. Another 43 wins & 38 nominations.,1,43,38,82
5569,Metropolitan,Nominated for 1 Oscar. Another 6 wins & 9 nominations.,1,6,9,16
5570,Nuns on the Run,,0,0,0,0
5571,Men of Respect,1 nomination.,0,0,1,1
5572,Flatliners,Nominated for 1 Oscar. Another 2 nominations.,1,0,2,3
5573,Men at Work,,0,0,0,0
5574,Men Don't Leave,3 nominations.,0,0,3,3
5575,Memphis Belle,Nominated for 1 BAFTA Film Award. Another 1 win & 3 nominations.,0,1,4,5
5576,Graffiti Bridge,1 win & 6 nominations.,0,1,6,7
5577,Air America,1 nomination.,0,0,1,1
5578,Graveyard Shift,1 nomination.,0,0,1,1
5579,Meet the Applegates,,0,0,0,0
5580,Green Card,Nominated for 1 Oscar. Another 3 wins & 3 nominations.,1,3,3,7
5581,Opportunity Knocks,,0,0,0,0
5582,An Angel at My Table,18 wins & 4 nominations.,0,18,4,22
5583,Mister Johnson,1 win & 1 nomination.,0,1,1,2
5584,Two Evil Eyes,2 nominations.,0,0,2,2
5585,Ghost Dad,3 nominations.,0,0,3,3
5586,My Mother's Castle,1 win & 5 nominations.,0,1,5,6
5587,Tremors,5 nominations.,0,0,5,5
5588,Narrow Margin,1 nomination.,0,0,1,1
5589,Navy Seals,,0,0,0,0
5590,My Father's Glory,2 wins & 4 nominations.,0,2,4,6
5591,My Blue Heaven,,0,0,0,0
5592,Almost an Angel,,0,0,0,0
5593,Gate 2: The Trespassers,,0,0,0,0
5594,Truly Madly Deeply,Won 1 BAFTA Film Award. Another 16 wins & 7 nominations.,0,17,7,24
5595,Mr. Destiny,,0,0,0,0
5596,Night of the Living Dead,6 wins.,0,6,0,6
5597,Mr. & Mrs. Bridge,9 wins & 18 nominations.,0,9,18,27
5598,Nightbreed,7 wins & 4 nominations.,0,7,4,11
5599,Tune in Tomorrow...,2 wins.,0,2,0,2
5600,To Sleep with Anger,7 wins & 10 nominations.,0,7,10,17
5601,Mountains of the Moon,1 win.,0,1,0,1
5602,Frankenhooker,,0,0,0,0
5603,Ghost,Won 2 Oscars. Another 16 wins & 23 nominations.,2,16,23,41
5604,Angel Town,,0,0,0,0
5605,Gremlins 2: The New Batch,6 nominations.,0,0,6,6
5606,Lionheart,,0,0,0,0
5607,Heart Condition,,0,0,0,0
5608,Presumed Innocent,1 win & 2 nominations.,0,1,2,3
5609,Everybody Wins,1 nomination.,0,0,1,1
5610,American Ninja 4: The Annihilation,,0,0,0,0
5611,A Tale of Springtime,,0,0,0,0
5612,Europa Europa,Nominated for 1 Oscar. Another 8 wins & 7 nominations.,1,8,7,16
5613,Waiting for the Light,,0,0,0,0
5614,Auntie Danielle,3 nominations.,0,0,3,3
5615,Love & Murder,2 wins & 1 nomination.,0,2,1,3
5616,Problem Child,1 nomination.,0,0,1,1
5617,Avalon,4 wins & 1 nomination.,0,4,1,5
5618,Flashback,,0,0,0,0
5619,Lord of the Flies,3 nominations.,0,0,3,3
5620,Loose Cannons,29 wins & 24 nominations.,0,29,24,53
5621,Look Who's Talking Too,3 nominations.,0,0,3,3
5622,A Show of Force,,0,0,0,0
5623,A Shock to the System,1 nomination.,0,0,1,1
5624,Pump Up the Volume,3 wins & 5 nominations.,0,3,5,8
5625,Ernest Goes to Jail,,0,0,0,0
5626,Awakenings,Nominated for 3 Oscars. Another 6 wins & 8 nominations.,3,6,8,17
5627,Heaven and Earth,1 win & 6 nominations.,0,1,6,7
5628,Love at Large,,0,0,0,0
5629,Predator 2,1 win & 4 nominations.,0,1,4,5
5630,Postcards from the Edge,Nominated for 2 Oscars. Another 2 wins & 10 nominations.,2,2,10,14
5631,May Fools,Nominated for 1 BAFTA Film Award. Another 2 wins & 6 nominations.,0,2,7,9
5632,"After Dark, My Sweet",1 nomination.,0,0,1,1
5633,Another 48 Hrs.,,0,0,0,0
5634,Pacific Heights,,0,0,0,0
5635,Fire Birds,,0,0,0,0
5636,Marked for Death,,0,0,0,0
5637,The Witches,Nominated for 1 BAFTA Film Award. Another 3 wins & 7 nominations.,0,3,8,11
5638,Happily Ever After,,0,0,0,0
5639,Madhouse,,0,0,0,0
5640,Arachnophobia,2 wins & 5 nominations.,0,2,5,7
5641,Archangel,,0,0,0,0
5642,Hard to Kill,,0,0,0,0
5643,Hardware,3 wins & 3 nominations.,0,3,3,6
5644,Vincent & Theo,1 win.,0,1,0,1
5645,Vital Signs,,0,0,0,0
5646,The Two Jakes,,0,0,0,0
5647,Havana,Nominated for 1 Oscar. Another 2 nominations.,1,0,2,3
5648,The Field,Nominated for 1 Oscar. Another 3 nominations.,1,0,3,4
5649,Downtown,,0,0,0,0
5650,Mo' Better Blues,1 win & 3 nominations.,0,1,3,4
5651,Death Warrant,,0,0,0,0
5652,The First Power,,0,0,0,0
5653,The NeverEnding Story II: The Next Chapter,2 wins & 4 nominations.,0,2,4,6
5654,Cry-Baby,,0,0,0,0
5655,Days of Thunder,Nominated for 1 Oscar. Another 1 win & 1 nomination.,1,1,1,3
5656,The Last of the Finest,1 nomination.,0,0,1,1
5657,Stanley & Iris,,0,0,0,0
5658,Child's Play 2,1 win.,0,1,0,1
5659,The Nasty Girl,Nominated for 1 Oscar. Another 11 wins & 5 nominations.,1,11,5,17
5660,The Comfort of Strangers,1 win.,0,1,0,1
5661,Short Time,,0,0,0,0
5662,Crossing the Line,,0,0,0,0
5663,The Freshman,1 win & 2 nominations.,0,1,2,3
5664,The Godfather: Part III,Nominated for 7 Oscars. Another 6 wins & 16 nominations.,7,6,16,29
5665,The Boyfriend School,,0,0,0,0
5666,Texasville,,0,0,0,0
5667,Body Chemistry,,0,0,0,0
5668,The Grifters,Nominated for 4 Oscars. Another 10 wins & 17 nominations.,4,10,17,31
5669,Slumber Party Massacre III,,0,0,0,0
5670,The Hot Spot,,0,0,0,0
5671,Delta Force 2: The Colombian Connection,,0,0,0,0
5672,Days of Being Wild,17 wins & 9 nominations.,0,17,9,26
5673,Def by Temptation,1 nomination.,0,0,1,1
5674,Daddy's Dyin'... Who's Got the Will?,,0,0,0,0
5675,Ski Patrol,,0,0,0,0
5676,Dances with Wolves,Won 7 Oscars. Another 44 wins & 38 nominations.,7,44,38,89
5677,Come See the Paradise,3 nominations.,0,0,3,3
5678,The Bonfire of the Vanities,1 win & 5 nominations.,0,1,5,6
5679,The Long Walk Home,1 win & 2 nominations.,0,1,2,3
5680,The Adventures of Ford Fairlane,5 wins & 3 nominations.,0,5,3,8
5681,Book of Love,1 nomination.,0,0,1,1
5682,Side Out,,0,0,0,0
5683,The Hunt for Red October,Won 1 Oscar. Another 2 wins & 8 nominations.,1,2,8,11
5684,Bird on a Wire,,0,0,0,0
5685,Cyrano de Bergerac,Won 1 Oscar. Another 30 wins & 29 nominations.,1,30,29,60
5686,Sibling Rivalry,,0,0,0,0
5687,C'est la vie,21 nominations.,0,0,21,21
5688,Streets,,0,0,0,0
5689,Dick Tracy,Won 3 Oscars. Another 6 wins & 36 nominations.,3,6,36,45
5690,The Hairdresser's Husband,Nominated for 1 BAFTA Film Award. Another 1 win & 7 nominations.,0,1,8,9
5691,Strike It Rich,,0,0,0,0
5692,Die Hard 2,1 win & 1 nomination.,0,1,1,2
5693,Darkman,3 wins & 8 nominations.,0,3,8,11
5694,State of Grace,,0,0,0,0
5695,Close-Up,2 wins & 2 nominations.,0,2,2,4
5696,The Fourth War,,0,0,0,0
5697,Desperate Hours,1 nomination.,0,0,1,1
5698,China Cry: A True Story,,0,0,0,0
5699,The Misadventures of Mr. Wilt,,0,0,0,0
5700,Cadillac Man,,0,0,0,0
5701,The End of Innocence,,0,0,0,0
5702,Taking Care of Business,,0,0,0,0
5703,Crazy People,,0,0,0,0
5704,Chicago Joe and the Showgirl,,0,0,0,0
5705,Brain Dead,,0,0,0,0
5706,Coupe de Ville,,0,0,0,0
5707,Tales from the Darkside: The Movie,1 win.,0,1,0,1
5708,The Haunting of Morella,,0,0,0,0
5709,Soultaker,1 win.,0,1,0,1
5710,The Exorcist III,2 wins & 5 nominations.,0,2,5,7
5711,The Forbidden Dance,1 nomination.,0,0,1,1
5712,Courage Mountain,,0,0,0,0
5713,Cadence,1 nomination.,0,0,1,1
5714,Spaced Invaders,,0,0,0,0
5715,Class of 1999,1 nomination.,0,0,1,1
5716,Betsy's Wedding,3 nominations.,0,0,3,3
5717,Taxi Blues,Nominated for 1 Golden Globe. Another 3 wins & 6 nominations.,0,3,7,10
5718,The Krays,Nominated for 1 BAFTA Film Award. Another 4 wins & 1 nomination.,0,4,2,6
5719,Harlem Nights,Nominated for 1 Oscar. Another 2 wins & 1 nomination.,1,2,1,4
5720,Stepfather II,,0,0,0,0
5721,A Dry White Season,Nominated for 1 Oscar. Another 2 wins & 7 nominations.,1,2,7,10
5722,Staying Together,1 win & 1 nomination.,0,1,1,2
5723,Fletch Lives,,0,0,0,0
5724,Jesus of Montreal,Nominated for 1 Oscar. Another 18 wins & 11 nominations.,1,18,11,30
5725,K-9,,0,0,0,0
5726,Steel Magnolias,Nominated for 1 Oscar. Another 2 wins & 6 nominations.,1,2,6,9
5727,The Fly II,3 nominations.,0,0,3,3
5728,The Big Picture,,0,0,0,0
5729,Three Fugitives,1 nomination.,0,0,1,1
5730,Police Academy 6: City Under Siege,,0,0,0,0
5731,Longtime Companion,Nominated for 1 Oscar. Another 6 wins & 5 nominations.,1,6,5,12
5732,Dark Obsession,2 nominations.,0,0,2,2
5733,Bye Bye Blues,5 wins & 10 nominations.,0,5,10,15
5734,The Unbelievable Truth,2 nominations.,0,0,2,2
5735,84C MoPic,3 nominations.,0,0,3,3
5736,Old Gringo,1 nomination.,0,0,1,1
5737,Chattahoochee,,0,0,0,0
5738,Worth Winning,,0,0,0,0
5739,Parents,1 win & 2 nominations.,0,1,2,3
5740,Beverly Hills Brats,,0,0,0,0
5741,"Honey, I Shrunk the Kids",Won 1 BAFTA Film Award. Another 1 win & 10 nominations.,0,2,10,12
5742,Dead Poets Society,Won 1 Oscar. Another 19 wins & 19 nominations.,1,19,19,39
5743,Field of Dreams,Nominated for 3 Oscars. Another 7 wins & 10 nominations.,3,7,10,20
5744,Lost Angels,1 nomination.,0,0,1,1
5745,The Wizard,4 nominations.,0,0,4,4
5746,Fat Man and Little Boy,2 nominations.,0,0,2,2
5747,Dead Bang,,0,0,0,0
5748,Cheetah,1 nomination.,0,0,1,1
5749,Major League,1 nomination.,0,0,1,1
5750,Loverboy,,0,0,0,0
5751,Cannonball Fever,,0,0,0,0
5752,Heart of Dixie,1 nomination.,0,0,1,1
5753,Fast Food,,0,0,0,0
5754,Farewell to the King,,0,0,0,0
5755,Who's Harry Crumb?,,0,0,0,0
5756,Look Who's Talking,5 wins & 2 nominations.,0,5,2,7
5757,Johnny Handsome,3 nominations.,0,0,3,3
5758,The War of the Roses,Nominated for 3 Golden Globes. Another 2 wins & 6 nominations.,0,2,9,11
5759,Fist Fighter,,0,0,0,0
5760,Pet Sematary,1 win & 5 nominations.,0,1,5,6
5761,Born on the Fourth of July,Won 2 Oscars. Another 13 wins & 26 nominations.,2,13,26,41
5762,Physical Evidence,1 win.,0,1,0,1
5763,Violent Cop,3 wins & 1 nomination.,0,3,1,4
5764,Family Business,,0,0,0,0
5765,Pink Cadillac,,0,0,0,0
5766,The Dream Team,,0,0,0,0
5767,The Horror Show,1 nomination.,0,0,1,1
5768,Star Trek V: The Final Frontier,4 wins & 3 nominations.,0,4,3,7
5769,"I, Madman",1 win & 1 nomination.,0,1,1,2
5770,Casualties of War,Nominated for 1 Golden Globe. Another 1 win & 4 nominations.,0,1,5,6
5771,An Innocent Man,,0,0,0,0
5772,Troop Beverly Hills,,0,0,0,0
5773,Ghostbusters II,2 wins & 1 nomination.,0,2,1,3
5774,Terror a bordo,,0,0,0,0
5775,All Dogs Go to Heaven,1 nomination.,0,0,1,1
5776,Cookie,,0,0,0,0
5777,Mortal Passions,2 nominations.,0,0,2,2
5778,After Midnight,2 wins & 4 nominations.,0,2,4,6
5779,Turner & Hooch,,0,0,0,0
5780,Blind Fury,,0,0,0,0
5781,Getting It Right,,0,0,0,0
5782,Gross Anatomy,,0,0,0,0
5783,Blaze,Nominated for 1 Oscar. Another 1 win & 2 nominations.,1,1,2,4
5784,A Chorus of Disapproval,,0,0,0,0
5785,How I Got Into College,,0,0,0,0
5786,Winter People,,0,0,0,0
5787,Music Box,Nominated for 1 Oscar. Another 1 win & 2 nominations.,1,1,2,4
5788,Sweetie,3 wins & 8 nominations.,0,3,8,11
5789,True Believer,1 win & 1 nomination.,0,1,1,2
5790,Monsieur Hire,6 wins & 8 nominations.,0,6,8,14
5791,The Karate Kid Part III,5 nominations.,0,0,5,5
5792,Kinjite: Forbidden Subjects,,0,0,0,0
5793,Bloodhounds of Broadway,1 nomination.,0,0,1,1
5794,Chameleon Street,1 win & 1 nomination.,0,1,1,2
5795,Tap,1 nomination.,0,0,1,1
5796,Tango & Cash,Nominated for 1 Oscar. Another 8 wins & 10 nominations.,1,8,10,19
5797,Cousins,,0,0,0,0
5798,Uncle Buck,,0,0,0,0
5799,Crack House,,0,0,0,0
5800,Blue Steel,2 wins & 1 nomination.,0,2,1,3
5801,Miss Firecracker,1 nomination.,0,0,1,1
5802,Gleaming the Cube,,0,0,0,0
5803,The January Man,,0,0,0,0
5804,UHF,,0,0,0,0
5805,Glory,Won 3 Oscars. Another 11 wins & 18 nominations.,3,11,18,32
5806,Teen Witch,2 nominations.,0,0,2,2
5807,Great Balls of Fire!,1 win & 1 nomination.,0,1,1,2
5808,Bloodfist,,0,0,0,0
5809,Crimes and Misdemeanors,Nominated for 3 Oscars. Another 16 wins & 23 nominations.,3,16,23,42
5810,Wild Orchid,2 nominations.,0,0,2,2
5811,Always,3 nominations.,0,0,3,3
5812,Bill & Ted's Excellent Adventure,,0,0,0,0
5813,Wired,,0,0,0,0
5814,Torrents of Spring,1 nomination.,0,0,1,1
5815,New York Stories,1 win.,0,1,0,1
5816,Too Beautiful for You,6 wins & 7 nominations.,0,6,7,13
5817,Next of Kin,1 nomination.,0,0,1,1
5818,The Lemon Sisters,,0,0,0,0
5819,Night Game,,0,0,0,0
5820,Night Visitor,,0,0,0,0
5821,Kickboxer,,0,0,0,0
5822,Communion,1 nomination.,0,0,1,1
5823,Powwow Highway,2 wins & 4 nominations.,0,2,4,6
5824,Dad,Nominated for 1 Oscar. Another 2 wins & 4 nominations.,1,2,4,7
5825,No Holds Barred,,0,0,0,0
5826,Wicked Stepmother,1 nomination.,0,0,1,1
5827,The Little Mermaid,Won 2 Oscars. Another 12 wins & 8 nominations.,2,12,8,22
5828,"Mama, There's a Man in Your Bed",,0,0,0,0
5829,"The Cook, the Thief, His Wife & Her Lover",7 wins & 11 nominations.,0,7,11,18
5830,Tie Me Up! Tie Me Down!,8 wins & 19 nominations.,0,8,19,27
5831,Friday the 13th Part VIII: Jason Takes Manhattan,2 nominations.,0,0,2,2
5832,Cyborg,,0,0,0,0
5833,Halloween 5,1 win.,0,1,0,1
5834,American Ninja 3: Blood Hunt,,0,0,0,0
5835,Triumph of the Spirit,,0,0,0,0
5836,Martians Go Home,,0,0,0,0
5837,My Left Foot,Won 2 Oscars. Another 21 wins & 20 nominations.,2,21,20,43
5838,Chances Are,Nominated for 1 Oscar. Another 1 win & 1 nomination.,1,1,1,3
5839,The 'Burbs,1 nomination.,0,0,1,1
5840,Black Rain,Nominated for 2 Oscars. Another 1 win & 2 nominations.,2,1,2,5
5841,My Twentieth Century,1 win.,0,1,0,1
5842,The Abyss,Won 1 Oscar. Another 8 wins & 15 nominations.,1,8,15,24
5843,How to Make Love to a Negro Without Getting Tired,2 nominations.,0,0,2,2
5844,Mystery Train,1 win & 8 nominations.,0,1,8,9
5845,The Gods Must Be Crazy II,1 nomination.,0,0,1,1
5846,How to Get Ahead in Advertising,,0,0,0,0
5847,Cruising Bar,1 win & 3 nominations.,0,1,3,4
5848,National Lampoon's Christmas Vacation,,0,0,0,0
5849,Valmont relaciones peligrosas,,0,0,0,0
5850,Kill Me Again,1 win.,0,1,0,1
5851,Strapless,,0,0,0,0
5852,Parenthood,Nominated for 2 Oscars. Another 4 wins & 12 nominations.,2,4,12,18
5853,Prancer,2 nominations.,0,0,2,2
5854,Weekend at Bernie's,1 nomination.,0,0,1,1
5855,"Bert Rigby, You're a Fool",1 nomination.,0,0,1,1
5856,Do the Right Thing,Nominated for 2 Oscars. Another 21 wins & 15 nominations.,2,21,15,38
5857,Let It Ride,,0,0,0,0
5858,Skin Deep,,0,0,0,0
5859,When Harry Met Sally...,Nominated for 1 Oscar. Another 4 wins & 16 nominations.,1,4,16,21
5860,Rude Awakening,,0,0,0,0
5861,Batman,Won 1 Oscar. Another 8 wins & 26 nominations.,1,8,26,35
5862,Drugstore Cowboy,12 wins & 11 nominations.,0,12,11,23
5863,Shirley Valentine,Nominated for 2 Oscars. Another 4 wins & 7 nominations.,2,4,7,13
5864,Eddie and the Cruisers II: Eddie Lives!,1 nomination.,0,0,1,1
5865,Edge of Sanity,,0,0,0,0
5866,Welcome Home,,0,0,0,0
5867,Shocker,1 nomination.,0,0,1,1
5868,The Package,1 win & 2 nominations.,0,1,2,3
5869,We're No Angels,,0,0,0,0
5870,See You in the Morning,,0,0,0,0
5871,Driving Miss Daisy,Won 4 Oscars. Another 17 wins & 24 nominations.,4,17,24,45
5872,In Country,,0,0,0,0
5873,Lisa,2 nominations.,0,0,2,2
5874,Jacknife,,0,0,0,0
5875,River of Death,,0,0,0,0
5876,The Tall Guy,,0,0,0,0
5877,Best of the Best,1 nomination.,0,0,1,1
5878,Enemies: A Love Story,Nominated for 3 Oscars. Another 4 wins & 7 nominations.,3,4,7,14
5879,Robot Jox,1 nomination.,0,0,1,1
5880,Slaves of New York,,0,0,0,0
5881,The Fabulous Baker Boys,Nominated for 4 Oscars. Another 14 wins & 13 nominations.,4,14,13,31
5882,Immediate Family,1 win & 2 nominations.,0,1,2,3
5883,Queen of Hearts,24 wins & 19 nominations.,0,24,19,43
5884,Henry V,Won 1 Oscar. Another 10 wins & 13 nominations.,1,10,13,24
5885,Erik the Viking,,0,0,0,0
5886,Shag,2 nominations.,0,0,2,2
5887,Cage,,0,0,0,0
5888,Romero,2 nominations.,0,0,2,2
5889,Rooftops,1 nomination.,0,0,1,1
5890,"Sex, Lies, and Videotape",Nominated for 1 Oscar. Another 15 wins & 23 nominations.,1,15,23,39
5891,Rosalie Goes Shopping,1 win & 1 nomination.,0,1,1,2
5892,She's Out of Control,1 win & 1 nomination.,0,1,1,2
5893,She-Devil,,0,0,0,0
5894,Disorganized Crime,,0,0,0,0
5895,Road House,5 nominations.,0,0,5,5
5896,Lean on Me,4 wins & 5 nominations.,0,4,5,9
5897,Back to the Future Part II,Nominated for 1 Oscar. Another 9 wins & 8 nominations.,1,9,8,18
5898,The Return of Swamp Thing,1 win.,0,1,0,1
5899,DeepStar Six,,0,0,0,0
5900,The Experts,,0,0,0,0
5901,Breaking In,1 win & 1 nomination.,0,1,1,2
5902,The Rachel Papers,1 win.,0,1,0,1
5903,Little Nemo: Adventures in Slumberland,1 win & 1 nomination.,0,1,1,2
5904,Her Alibi,1 nomination.,0,0,1,1
5905,Signs of Life,2 wins & 2 nominations.,0,2,2,4
5906,Brenda Starr,,0,0,0,0
5907,Renegades,1 win & 1 nomination.,0,1,1,2
5908,A Nightmare on Elm Street 5: The Dream Child,3 wins & 2 nominations.,0,3,2,5
5909,The Mighty Quinn,1 win & 2 nominations.,0,1,2,3
5910,Last Exit to Brooklyn,6 wins & 1 nomination.,0,6,1,7
5911,Warlock,1 win & 7 nominations.,0,1,7,8
5912,Relentless,,0,0,0,0
5913,Scenes from the Class Struggle in Beverly Hills,1 win & 1 nomination.,0,1,1,2
5914,The Toxic Avenger Part II,1 nomination.,0,0,1,1
5915,The Toxic Avenger Part III: The Last Temptation of Toxie,1 nomination.,0,0,1,1
5916,Licence to Kill,,0,0,0,0
5917,Say Anything...,,0,0,0,0
5918,Lock Up,3 nominations.,0,0,3,3
5919,Little Monsters,3 wins & 10 nominations.,0,3,10,13
5920,The Blood of Heroes,,0,0,0,0
5921,Sea of Love,4 nominations.,0,0,4,4
5922,Dream a Little Dream,,0,0,0,0
5923,"See No Evil, Hear No Evil",,0,0,0,0
5924,Hell High,,0,0,0,0
5925,Lethal Weapon 2,Nominated for 1 Oscar. Another 1 win & 1 nomination.,1,1,1,3
5926,Indiana Jones and the Last Crusade,Won 1 Oscar. Another 7 wins & 22 nominations.,1,7,22,30
5927,Listen to Me,1 win & 2 nominations.,0,1,2,3
5928,Life and Nothing But,Won 1 BAFTA Film Award. Another 8 wins & 14 nominations.,0,9,14,23
5929,The Terror Within,,0,0,0,0
5930,Second Sight,,0,0,0,0
5931,The Rainbow,1 nomination.,0,0,1,1
5932,Night of the Demons,,0,0,0,0
5933,My Stepmother Is an Alien,4 nominations.,0,0,4,4
5934,Sunset,Nominated for 1 Oscar. Another 1 win & 1 nomination.,1,1,1,3
5935,Funny Farm,,0,0,0,0
5936,Iron Eagle II,3 nominations.,0,0,3,3
5937,Vampire's Kiss,1 win & 2 nominations.,0,1,2,3
5938,Short Circuit 2,2 nominations.,0,0,2,2
5939,Shoot to Kill,2 nominations.,0,0,2,2
5940,She's Having a Baby,,0,0,0,0
5941,The Chocolate War,2 nominations.,0,0,2,2
5942,Hero and the Terror,,0,0,0,0
5943,Earth Girls Are Easy,3 nominations.,0,0,3,3
5944,Action Jackson,2 nominations.,0,0,2,2
5945,Crossing Delancey,2 nominations.,0,0,2,2
5946,Return to Snowy River,2 nominations.,0,0,2,2
5947,Fright Night Part 2,2 nominations.,0,0,2,2
5948,Halloween 4: The Return of Michael Myers,1 win & 2 nominations.,0,1,2,3
5949,The Last Temptation of Christ,Nominated for 1 Oscar. Another 2 wins & 6 nominations.,1,2,6,9
5950,Torch Song Trilogy,1 win & 3 nominations.,0,1,3,4
5951,Friday the 13th Part VII: The New Blood,4 nominations.,0,0,4,4
5952,Without a Clue,1 win & 1 nomination.,0,1,1,2
5953,Return of the Living Dead II,3 nominations.,0,0,3,3
5954,Fresh Horses,,0,0,0,0
5955,Mystic Pizza,1 win & 4 nominations.,0,1,4,5
5956,Above the Law,1 nomination.,0,0,1,1
5957,Track 29,1 win & 2 nominations.,0,1,2,3
5958,El Hotel de los Fantasmas,,0,0,0,0
5959,The Accidental Tourist,Won 1 Oscar. Another 3 wins & 11 nominations.,1,3,11,15
5960,Maniac Cop,,0,0,0,0
5961,Lady in White,1 win & 4 nominations.,0,1,4,5
5962,Die Hard,Nominated for 4 Oscars. Another 8 wins & 2 nominations.,4,8,2,14
5963,The Boost,1 nomination.,0,0,1,1
5964,Eight Men Out,2 nominations.,0,0,2,2
5965,Bat*21,1 nomination.,0,0,1,1
5966,Beetlejuice,Won 1 Oscar. Another 6 wins & 11 nominations.,1,6,11,18
5967,Salsa,1 nomination.,0,0,1,1
5968,Tequila Sunrise,Nominated for 1 Oscar. Another 2 wins & 2 nominations.,1,2,2,5
5969,Running on Empty,Nominated for 2 Oscars. Another 5 wins & 6 nominations.,2,5,6,13
5970,Taffin,,0,0,0,0
5971,Cop,,0,0,0,0
5972,Willow,Nominated for 2 Oscars. Another 1 win & 9 nominations.,2,1,9,12
5973,Two Moon Junction,1 win.,0,1,0,1
5974,Last Rites,,0,0,0,0
5975,Alien Nation,1 win & 4 nominations.,0,1,4,5
5976,Mississippi Burning,Won 1 Oscar. Another 16 wins & 24 nominations.,1,16,24,41
5977,Las travesuras de una pelirojja,,0,0,0,0
5978,Miracle Mile,2 wins & 5 nominations.,0,2,5,7
5979,Salaam Bombay!,Nominated for 1 Oscar. Another 13 wins & 7 nominations.,1,13,7,21
5980,Salome's Last Dance,,0,0,0,0
5981,Miles from Home,1 nomination.,0,0,1,1
5982,The Dead Pool,,0,0,0,0
5983,Scrooged,Nominated for 1 Oscar. Another 1 win & 4 nominations.,1,1,4,6
5984,Midnight Run,2 wins & 4 nominations.,0,2,4,6
5985,Bloodsport,1 nomination.,0,0,1,1
5986,Beaches,Nominated for 1 Oscar. Another 1 win & 5 nominations.,1,1,5,7
5987,Gorillas in the Mist,Nominated for 5 Oscars. Another 6 wins & 4 nominations.,5,6,4,15
5988,Al borde del terror,,0,0,0,0
5989,Akira,1 win.,0,1,0,1
5990,Talk Radio,3 wins & 5 nominations.,0,3,5,8
5991,Messenger of Death,,0,0,0,0
5992,Bull Durham,Nominated for 1 Oscar. Another 7 wins & 5 nominations.,1,7,5,13
5993,The Presidio,,0,0,0,0
5994,School Daze,1 nomination.,0,0,1,1
5995,A Handful of Dust,Nominated for 1 Oscar. Another 3 wins & 3 nominations.,1,3,3,7
5996,Caddyshack II,4 wins & 2 nominations.,0,4,2,6
5997,Criminal Law,1 win.,0,1,0,1
5998,Twins,Nominated for 1 Golden Globe. Another 4 wins.,0,4,1,5
5999,A Cry in the Dark,Nominated for 1 Oscar. Another 8 wins & 11 nominations.,1,8,11,20
6000,Switching Channels,2 nominations.,0,0,2,2
6001,Dirty Rotten Scoundrels,1 win & 1 nomination.,0,1,1,2
6002,Married to the Mob,Nominated for 1 Oscar. Another 6 wins & 4 nominations.,1,6,4,11
6003,Rocket Gibraltar,,0,0,0,0
6004,Cinema Paradiso,Won 1 Oscar. Another 24 wins & 32 nominations.,1,24,32,57
6005,Masquerade,22 wins & 16 nominations.,0,22,16,38
6006,Sweet Hearts Dance,,0,0,0,0
6007,Shakedown,,0,0,0,0
6008,Killer Klowns from Outer Space,2 nominations.,0,0,2,2
6009,Gandahar,1 nomination.,0,0,1,1
6010,The Land Before Time,2 nominations.,0,0,2,2
6011,License to Drive,2 wins & 1 nomination.,0,2,1,3
6012,Crocodile Dundee II,2 wins.,0,2,0,2
6013,The Lair of the White Worm,1 win & 3 nominations.,0,1,3,4
6014,Mr. North,,0,0,0,0
6015,Monkey Shines,7 wins & 1 nomination.,0,7,1,8
6016,"Distant Voices, Still Lives",10 wins & 7 nominations.,0,10,7,17
6017,The Kiss,1 win.,0,1,0,1
6018,Tucker: The Man and His Dream,Nominated for 3 Oscars. Another 8 wins & 6 nominations.,3,8,6,17
6019,Moving,1 nomination.,0,0,1,1
6020,The Rescue,1 nomination.,0,0,1,1
6021,Critters 2,1 win & 3 nominations.,0,1,3,4
6022,High Hopes,5 wins & 5 nominations.,0,5,5,10
6023,Hot to Trot,5 nominations.,0,0,5,5
6024,The Great Outdoors,,0,0,0,0
6025,Moon Over Parador,,0,0,0,0
6026,Dominick and Eugene,Nominated for 1 Golden Globe. Another 1 win & 1 nomination.,0,1,2,3
6027,The Deceivers,,0,0,0,0
6028,Drowning by Numbers,3 wins & 1 nomination.,0,3,1,4
6029,D.O.A.,1 win.,0,1,0,1
6030,Red Heat,,0,0,0,0
6031,The Serpent and the Rainbow,1 nomination.,0,0,1,1
6032,Pumpkinhead,3 nominations.,0,0,3,3
6033,Spellbinder,,0,0,0,0
6034,Dead Ringers,20 wins & 14 nominations.,0,20,14,34
6035,The Beast of War,1 win.,0,1,0,1
6036,Pass the Ammo,,0,0,0,0
6037,The Bear,Nominated for 1 Oscar. Another 5 wins & 10 nominations.,1,5,10,16
6038,Feds,,0,0,0,0
6039,Judgement in Berlin,,0,0,0,0
6040,Betrayed,,0,0,0,0
6041,Camille Claudel,Nominated for 2 Oscars. Another 7 wins & 12 nominations.,2,7,12,21
6042,Tapeheads,,0,0,0,0
6043,Cameron's Closet,1 nomination.,0,0,1,1
6044,Dead Heat,1 nomination.,0,0,1,1
6045,Ernest Saves Christmas,,0,0,0,0
6046,Paperhouse,3 wins & 1 nomination.,0,3,1,4
6047,They Live,3 nominations.,0,0,3,3
6048,Punchline,1 win.,0,1,0,1
6049,Another Woman,1 win & 3 nominations.,0,1,3,4
6050,Big,Nominated for 2 Oscars. Another 11 wins & 12 nominations.,2,11,12,25
6051,Big Business,1 win & 1 nomination.,0,1,1,2
6052,The Naked Gun: From the Files of Police Squad!,1 nomination.,0,0,1,1
6053,Frantic,,0,0,0,0
6054,The Wrong Guys,,0,0,0,0
6055,Stand and Deliver,Nominated for 1 Oscar. Another 11 wins & 6 nominations.,1,11,6,18
6056,Out of the Dark,,0,0,0,0
6057,Who Framed Roger Rabbit,Won 3 Oscars. Another 21 wins & 22 nominations.,3,21,22,46
6058,Luces de una gran ciudad,,0,0,0,0
6059,Jack's Back,1 nomination.,0,0,1,1
6060,The Blob,6 nominations.,0,0,6,6
6061,The Navigator: A Medieval Odyssey,21 wins & 4 nominations.,0,21,4,25
6062,Patty Hearst,2 nominations.,0,0,2,2
6063,Apartment Zero,5 wins & 1 nomination.,0,5,1,6
6064,Escorpion rojo,,0,0,0,0
6065,Hellbound: Hellraiser II,1 win & 5 nominations.,0,1,5,6
6066,Poltergeist III,2 nominations.,0,0,2,2
6067,Police Academy 5: Assignment: Miami Beach,1 nomination.,0,0,1,1
6068,Clean and Sober,1 win.,0,1,0,1
6069,As Tears Go By,2 wins & 10 nominations.,0,2,10,12
6070,The Milagro Beanfield War,Won 1 Oscar. Another 1 win & 2 nominations.,1,1,2,4
6071,The Unbearable Lightness of Being,Nominated for 2 Oscars. Another 7 wins & 11 nominations.,2,7,11,20
6072,Everybody's All-American,1 nomination.,0,0,1,1
6073,A Nightmare on Elm Street 4: The Dream Master,2 wins & 9 nominations.,0,2,9,11
6074,Platoon Leader,,0,0,0,0
6075,Little Nikita,,0,0,0,0
6076,The Unholy,,0,0,0,0
6077,Arthur 2: On the Rocks,1 win.,0,1,0,1
6078,The Big Blue,3 wins & 6 nominations.,0,3,6,9
6079,Young Einstein,1 win & 3 nominations.,0,1,3,4
6080,Some Girls,1 win.,0,1,0,1
6081,Young Guns,1 win & 2 nominations.,0,1,2,3
6082,I'm Gonna Git You Sucka,1 nomination.,0,0,1,1
6083,Phantasm II,2 nominations.,0,0,2,2
6084,Johnny Be Good,1 nomination.,0,0,1,1
6085,36 fillette,1 nomination.,0,0,1,1
6086,A Night in the Life of Jimmy Reardon,1 nomination.,0,0,1,1
6087,Buster,Nominated for 1 Oscar. Another 4 wins.,1,4,0,5
6088,Heartbreak Hotel,2 wins.,0,2,0,2
6089,Permanent Record,,0,0,0,0
6090,The Moderns,2 wins & 5 nominations.,0,2,5,7
6091,Braddock: Missing in Action III,1 nomination.,0,0,1,1
6092,Heart of Midnight,1 win.,0,1,0,1
6093,Waxwork,2 wins & 4 nominations.,0,2,4,6
6094,Appointment with Death,,0,0,0,0
6095,Illegally Yours,,0,0,0,0
6096,Things Change,2 wins & 2 nominations.,0,2,2,4
6097,The Good Mother,,0,0,0,0
6098,Colors,1 win & 1 nomination.,0,1,1,2
6099,Coming to America,Nominated for 2 Oscars. Another 5 wins & 3 nominations.,2,5,3,10
6100,Rambo III,2 wins & 5 nominations.,0,2,5,7
6101,For Keeps?,1 win & 1 nomination.,0,1,1,2
6102,For Queen & Country,2 wins.,0,2,0,2
6103,Child's Play,2 wins & 3 nominations.,0,2,3,5
6104,Working Girl,Won 1 Oscar. Another 8 wins & 17 nominations.,1,8,17,26
6105,Dangerous Liaisons,Won 3 Oscars. Another 18 wins & 21 nominations.,3,18,21,42
6106,Not of This Earth,,0,0,0,0
6107,Kansas,,0,0,0,0
6108,Tiger Warsaw,,0,0,0,0
6109,Biloxi Blues,,0,0,0,0
6110,Clara's Heart,Nominated for 1 Golden Globe. Another 3 nominations.,0,0,4,4
6111,Casual Sex?,,0,0,0,0
6112,Stormy Monday,1 win & 2 nominations.,0,1,2,3
6113,Time of the Gypsies,3 wins & 5 nominations.,0,3,5,8
6114,Story of Women,Nominated for 1 Golden Globe. Another 13 wins & 6 nominations.,0,13,7,20
6115,Women on the Verge of a Nervous Breakdown,Nominated for 1 Oscar. Another 22 wins & 23 nominations.,1,22,23,46
6116,The Couch Trip,,0,0,0,0
6117,A World Apart,Won 1 BAFTA Film Award. Another 6 wins & 12 nominations.,0,7,12,19
6118,The Adventures of Baron Munchausen,Nominated for 4 Oscars. Another 11 wins & 10 nominations.,4,11,10,25
6119,Elvira: Mistress of the Dark,1 win & 4 nominations.,0,1,4,5
6120,Heathers,3 wins & 11 nominations.,0,3,11,14
6121,976-EVIL,,0,0,0,0
6122,Bad Dreams,,0,0,0,0
6123,1969,1 nomination.,0,0,1,1
6124,Bird,Won 1 Oscar. Another 9 wins & 9 nominations.,1,9,9,19
6125,The Seventh Sign,1 win & 1 nomination.,0,1,1,2
6126,18 Again!,,0,0,0,0
6127,Off Limits,1 nomination.,0,0,1,1
6128,Memories of Me,,0,0,0,0
6129,Rain Man,Won 4 Oscars. Another 22 wins & 23 nominations.,4,22,23,49
6130,Vice Versa,1 win.,0,1,0,1
6131,And God Created Woman,1 nomination.,0,0,1,1
6132,Vibes,,0,0,0,0
6133,Stars and Bars,1 win.,0,1,0,1
6134,Stealing Home,,0,0,0,0
6135,Mac and Me,2 wins & 6 nominations.,0,2,6,8
6136,Oliver & Company,,0,0,0,0
6137,Big Top Pee-wee,1 nomination.,0,0,1,1
6138,A Fish Called Wanda,Won 1 Oscar. Another 8 wins & 18 nominations.,1,8,18,27
6139,The House on Carroll Street,1 win.,0,1,0,1
6140,Cocoon: The Return,4 nominations.,0,0,4,4
6141,Hiding Out,1 win.,0,1,0,1
6142,Malone,,0,0,0,0
6143,The Barbarians,1 nomination.,0,0,1,1
6144,Wall Street,Won 1 Oscar. Another 9 wins & 5 nominations.,1,9,5,15
6145,Matewan,Nominated for 1 Oscar. Another 2 wins & 7 nominations.,1,2,7,10
6146,Harry and the Hendersons,Won 1 Oscar. Another 1 win & 7 nominations.,1,1,7,9
6147,A Nightmare on Elm Street 3: Dream Warriors,1 win & 4 nominations.,0,1,4,5
6148,Hellraiser,2 wins & 6 nominations.,0,2,6,8
6149,Maurice,Nominated for 1 Oscar. Another 4 wins & 2 nominations.,1,4,2,7
6150,Born in East L.A.,4 wins.,0,4,0,4
6151,Light of Day,1 nomination.,0,0,1,1
6152,The Hidden,4 wins & 6 nominations.,0,4,6,10
6153,Masters of the Universe,2 wins & 5 nominations.,0,2,5,7
6154,Who's That Girl,Nominated for 1 Golden Globe. Another 2 wins & 6 nominations.,0,2,7,9
6155,Hamburger Hill,,0,0,0,0
6156,Hollywood Shuffle,4 wins & 3 nominations.,0,4,3,7
6157,Wanted: Dead or Alive,1 nomination.,0,0,1,1
6158,Like Father Like Son,23 wins & 47 nominations.,0,23,47,70
6159,White Mischief,,0,0,0,0
6160,The Chipmunk Adventure,1 nomination.,0,0,1,1
6161,A Prayer for the Dying,1 win.,0,1,0,1
6162,Lethal Weapon,Nominated for 1 Oscar. Another 7 wins & 1 nomination.,1,7,1,9
6163,The Big Town,,0,0,0,0
6164,Maid to Order,,0,0,0,0
6165,A Month in the Country,1 win.,0,1,0,1
6166,Leonard Part 6,3 wins & 4 nominations.,0,3,4,7
6167,Less Than Zero,1 nomination.,0,0,1,1
6168,Mannequin,Nominated for 1 Oscar. Another 5 wins & 3 nominations.,1,5,3,9
6169,The Allnighter,,0,0,0,0
6170,Hope and Glory,Nominated for 5 Oscars. Another 16 wins & 24 nominations.,5,16,24,45
6171,Boyfriends and Girlfriends,1 win & 4 nominations.,0,1,4,5
6172,The Bedroom Window,,0,0,0,0
6173,House II: The Second Story,1 nomination.,0,0,1,1
6174,The Hanoi Hilton,,0,0,0,0
6175,The Believers,1 nomination.,0,0,1,1
6176,The Grand Highway,8 wins & 4 nominations.,0,8,4,12
6177,White of the Eye,,0,0,0,0
6178,The Belly of an Architect,2 nominations.,0,0,2,2
6179,Hello Again,1 nomination.,0,0,1,1
6180,Cold Steel,,0,0,0,0
6181,Making Mr. Right,,0,0,0,0
6182,The Glass Menagerie,1 win & 6 nominations.,0,1,6,7
6183,La Bamba,3 wins & 3 nominations.,0,3,3,6
6184,Adventures in Babysitting,2 wins & 4 nominations.,0,2,4,6
6185,Teen Wolf Too,,0,0,0,0
6186,White Water Summer,,0,0,0,0
6187,A Man in Love,3 nominations.,0,0,3,3
6188,The Curse,1 nomination.,0,0,1,1
6189,Walk Like a Man,,0,0,0,0
6190,China Girl,1 nomination.,0,0,1,1
6191,My Best Friend Is a Vampire,,0,0,0,0
6192,Burglar,,0,0,0,0
6193,Extreme Prejudice,,0,0,0,0
6194,Death Before Dishonor,,0,0,0,0
6195,The Trouble with Spies,,0,0,0,0
6196,Assassination,16 wins & 51 nominations.,0,16,51,67
6197,Death Wish 4: The Crackdown,,0,0,0,0
6198,Evil Dead II,5 nominations.,0,0,5,5
6199,Predator,Nominated for 1 Oscar. Another 3 wins & 5 nominations.,1,3,5,9
6200,Jaws: The Revenge,1 win & 7 nominations.,0,1,7,8
6201,3 Men and a Baby,,0,0,0,0
6202,Someone to Watch Over Me,2 nominations.,0,0,2,2
6203,Some Kind of Wonderful,1 win.,0,1,0,1
6204,Prick Up Your Ears,Nominated for 1 Golden Globe. Another 5 wins & 7 nominations.,0,5,8,13
6205,Can't Buy Me Love,1 win & 3 nominations.,0,1,3,4
6206,Prince of Darkness,1 win & 1 nomination.,0,1,1,2
6207,Au Revoir les Enfants,Nominated for 2 Oscars. Another 28 wins & 11 nominations.,2,28,11,41
6208,Prison,1 nomination.,0,0,1,1
6209,The Monster Squad,3 wins & 4 nominations.,0,3,4,7
6210,Prom Night II,3 nominations.,0,0,3,3
6211,Police Academy 4: Citizens on Patrol,2 nominations.,0,0,2,2
6212,"Planes, Trains & Automobiles",1 nomination.,0,0,1,1
6213,The Untouchables,Won 1 Oscar. Another 10 wins & 16 nominations.,1,10,16,27
6214,Stakeout,2 wins.,0,2,0,2
6215,The Witches of Eastwick,Nominated for 2 Oscars. Another 5 wins & 11 nominations.,2,5,11,18
6216,Square Dance,1 nomination.,0,0,1,1
6217,Innerspace,Won 1 Oscar. Another 1 win & 4 nominations.,1,1,4,6
6218,The Fourth Protocol,1 nomination.,0,0,1,1
6219,Beyond Therapy,,0,0,0,0
6220,"Good Morning, Vietnam",Nominated for 1 Oscar. Another 7 wins & 3 nominations.,1,7,3,11
6221,The Whales of August,Nominated for 1 Oscar. Another 2 wins & 5 nominations.,1,2,5,8
6222,Dead of Winter,,0,0,0,0
6223,Fatal Beauty,2 wins.,0,2,0,2
6224,Fatal Attraction,Nominated for 6 Oscars. Another 7 wins & 16 nominations.,6,7,16,29
6225,Pelle the Conqueror,Won 1 Oscar. Another 21 wins & 9 nominations.,1,21,9,31
6226,Penitentiary III,,0,0,0,0
6227,Spaceballs,1 win.,0,1,0,1
6228,Personal Services,Nominated for 2 BAFTA Film Awards. Another 1 win.,0,1,2,3
6229,Aria,1 nomination.,0,0,1,1
6230,Deadly Illusion,,0,0,0,0
6231,Peter Kenna's The Good Wife,,0,0,0,0
6232,Beverly Hills Cop II,Nominated for 1 Oscar. Another 6 wins & 3 nominations.,1,6,3,10
6233,Ernest Goes to Camp,1 nomination.,0,0,1,1
6234,Best Seller,2 nominations.,0,0,2,2
6235,Overboard,3 nominations.,0,0,3,3
6236,Return to Horror High,,0,0,0,0
6237,Eat the Rich,,0,0,0,0
6238,"Rita, Sue and Bob Too",,0,0,0,0
6239,In the Mood,,0,0,0,0
6240,Dirty Dancing,Won 1 Oscar. Another 10 wins & 6 nominations.,1,10,6,17
6241,The Running Man,1 win & 3 nominations.,0,1,3,4
6242,The Rosary Murders,2 wins.,0,2,0,2
6243,Intervista,3 wins & 10 nominations.,0,3,10,13
6244,Barfly,5 nominations.,0,0,5,5
6245,Disorderlies,,0,0,0,0
6246,Roxanne,3 wins & 2 nominations.,0,3,2,5
6247,The Pick-up Artist,,0,0,0,0
6248,September,,0,0,0,0
6249,*batteries not included,2 wins & 1 nomination.,0,2,1,3
6250,Russkies,,0,0,0,0
6251,Sammy and Rosie Get Laid,,0,0,0,0
6252,Dragnet,,0,0,0,0
6253,The Princess Bride,Nominated for 1 Oscar. Another 7 wins & 8 nominations.,1,7,8,16
6254,Revenge of the Nerds II: Nerds in Paradise,,0,0,0,0
6255,Rent-a-Cop,1 win & 1 nomination.,0,1,1,2
6256,The Squeeze,,0,0,0,0
6257,Bagdad Cafe,Nominated for 1 Oscar. Another 14 wins & 5 nominations.,1,14,5,20
6258,Babette's Feast,Won 1 Oscar. Another 11 wins & 9 nominations.,1,11,9,21
6259,Baby Boom,Nominated for 2 Golden Globes. Another 3 nominations.,0,0,5,5
6260,Enemy Territory,,0,0,0,0
6261,Radio Days,Nominated for 2 Oscars. Another 3 wins & 9 nominations.,2,3,9,14
6262,Slam Dance,2 nominations.,0,0,2,2
6263,Back to the Beach,,0,0,0,0
6264,Raising Arizona,4 nominations.,0,0,4,4
6265,Ishtar,1 win & 3 nominations.,0,1,3,4
6266,Rampage,7 nominations.,0,0,7,7
6267,Benji the Hunted,1 win & 1 nomination.,0,1,1,2
6268,Empire of the Sun,Nominated for 6 Oscars. Another 13 wins & 11 nominations.,6,13,11,30
6269,"Silent Night, Deadly Night 2",,0,0,0,0
6270,Ironweed,Nominated for 2 Oscars. Another 2 wins & 2 nominations.,2,2,2,6
6271,Real Men,,0,0,0,0
6272,The Sicilian,,0,0,0,0
6273,Siesta,3 nominations.,0,0,3,3
6274,Shy People,2 wins & 2 nominations.,0,2,2,4
6275,Zombie High,,0,0,0,0
6276,The Secret of My Succe$s,,0,0,0,0
6277,Julia and Julia,1 win & 5 nominations.,0,1,5,6
6278,Broadcast News,Nominated for 7 Oscars. Another 15 wins & 17 nominations.,7,15,17,39
6279,Four Adventures of Reinette and Mirabelle,1 win & 1 nomination.,0,1,1,2
6280,Gardens of Stone,2 nominations.,0,0,2,2
6281,Over the Top,4 wins & 2 nominations.,0,4,2,6
6282,Withnail & I,1 win & 1 nomination.,0,1,1,2
6283,Summer School,1 nomination.,0,0,1,1
6284,Swimming to Cambodia,5 nominations.,0,0,5,5
6285,Cyclone,,0,0,0,0
6286,Wings of Desire,Nominated for 1 BAFTA Film Award. Another 19 wins & 13 nominations.,0,19,14,33
6287,Housekeeping,2 wins & 3 nominations.,0,2,3,5
6288,Blind Date,1 win.,0,1,0,1
6289,Street Smart,Nominated for 1 Oscar. Another 6 wins & 2 nominations.,1,6,2,9
6290,No Man's Land,Won 1 Oscar. Another 28 wins & 25 nominations.,1,28,25,54
6291,The Kindred,,0,0,0,0
6292,"No Retreat, No Surrender 2",,0,0,0,0
6293,Tin Men,,0,0,0,0
6294,The Killing Time,,0,0,0,0
6295,No Way Out,,0,0,0,0
6296,Tough Guys Don't Dance,1 win & 10 nominations.,0,1,10,11
6297,Near Dark,1 win & 8 nominations.,0,1,8,9
6298,The Living Daylights,3 wins & 4 nominations.,0,3,4,7
6299,The Principal,1 nomination.,0,0,1,1
6300,The Last Emperor,Won 9 Oscars. Another 51 wins & 22 nominations.,9,51,22,82
6301,Cross My Heart,,0,0,0,0
6302,Surrender,,0,0,0,0
6303,Wisdom,1 nomination.,0,0,1,1
6304,Black Widow,,0,0,0,0
6305,Amazon Women on the Moon,,0,0,0,0
6306,American Ninja 2: The Confrontation,,0,0,0,0
6307,My Demon Lover,1 nomination.,0,0,1,1
6308,Superman IV: The Quest for Peace,2 wins & 6 nominations.,0,2,6,8
6309,Full Metal Jacket,Nominated for 1 Oscar. Another 8 wins & 14 nominations.,1,8,14,23
6310,Wish You Were Here,10 wins & 23 nominations.,0,10,23,33
6311,From the Hip,1 nomination.,0,0,1,1
6312,Nadine,1 win & 1 nomination.,0,1,1,2
6313,From a Whisper to a Scream,,0,0,0,0
6314,Cry Freedom,Nominated for 3 Oscars. Another 5 wins & 13 nominations.,3,5,13,21
6315,Straight to Hell,,0,0,0,0
6316,Suspect,,0,0,0,0
6317,84 Charing Cross Road,Won 1 BAFTA Film Award. Another 2 wins & 4 nominations.,0,3,4,7
6318,Three O'Clock High,,0,0,0,0
6319,Date with an Angel,1 nomination.,0,0,1,1
6320,Angel Heart,2 wins & 4 nominations.,0,2,4,6
6321,Hunk,,0,0,0,0
6322,Creepshow 2,1 nomination.,0,0,1,1
6323,Steel Dawn,,0,0,0,0
6324,Anguish,5 wins & 2 nominations.,0,5,2,7
6325,The Garbage Pail Kids Movie,4 nominations.,0,0,4,4
6326,Steele Justice,,0,0,0,0
6327,North Shore,,0,0,0,0
6328,Dark Eyes,Nominated for 1 Oscar. Another 10 wins & 22 nominations.,1,10,22,33
6329,Flowers in the Attic,1 win & 1 nomination.,0,1,1,2
6330,The Dead,2 nominations.,0,0,2,2
6331,Five Corners,1 win & 3 nominations.,0,1,3,4
6332,World Gone Wild,1 nomination.,0,0,1,1
6333,The Lost Boys,3 wins & 5 nominations.,0,3,5,8
6334,T�nel al infierno,,0,0,0,0
6335,House of Games,Nominated for 1 Golden Globe. Another 6 wins & 4 nominations.,0,6,5,11
6336,Three for the Road,,0,0,0,0
6337,The Year My Voice Broke,6 wins & 3 nominations.,0,6,3,9
6338,Nuts,Nominated for 3 Golden Globes. Another 1 nomination.,0,0,4,4
6339,Critical Condition,,0,0,0,0
6340,Throw Momma from the Train,Nominated for 1 Oscar. Another 2 wins & 3 nominations.,1,2,3,6
6341,Moonstruck,Won 3 Oscars. Another 15 wins & 19 nominations.,3,15,19,37
6342,Morgan Stewart's Coming Home,,0,0,0,0
6343,Crazy Love,5 wins & 5 nominations.,0,5,5,10
6344,Outrageous Fortune,Nominated for 1 Golden Globe. Another 2 wins.,0,2,1,3
6345,Creepozoids,,0,0,0,0
6346,Knights of the City,,0,0,0,0
6347,"'night, Mother",Nominated for 1 Golden Globe. Another 1 nomination.,0,0,2,2
6348,�Three Amigos!,,0,0,0,0
6349,The Great Mouse Detective,1 win & 3 nominations.,0,1,3,4
6350,Killer Party,,0,0,0,0
6351,Iron Eagle,,0,0,0,0
6352,Invaders from Mars,2 nominations.,0,0,2,2
6353,Willy/Milly,,0,0,0,0
6354,King Kong Lives,2 nominations.,0,0,2,2
6355,In the Shadow of Kilimanjaro,,0,0,0,0
6356,The Decline of the American Empire,Nominated for 1 Oscar. Another 13 wins & 6 nominations.,1,13,6,20
6357,Wired to Kill,,0,0,0,0
6358,8 Million Ways to Die,1 nomination.,0,0,1,1
6359,Jake Speed,,0,0,0,0
6360,Wise Guys,,0,0,0,0
6361,Kangaroo,,0,0,0,0
6362,Jumpin' Jack Flash,2 nominations.,0,0,2,2
6363,The Fringe Dwellers,1 win & 7 nominations.,0,1,7,8
6364,52 Pick-Up,1 nomination.,0,0,1,1
6365,The Color of Money,Won 1 Oscar. Another 2 wins & 10 nominations.,1,2,10,13
6366,Care Bears Movie II: A New Generation,1 nomination.,0,0,1,1
6367,Just Between Friends,,0,0,0,0
6368,Caravaggio,3 wins & 1 nomination.,0,3,1,4
6369,Castaway,,0,0,0,0
6370,The Gospel According to Vic,1 win & 1 nomination.,0,1,1,2
6371,"Jo Jo Dancer, Your Life Is Calling",1 nomination.,0,0,1,1
6372,Jean de Florette,Won 4 BAFTA Film Awards. Another 7 wins & 17 nominations.,0,11,17,28
6373,Working Girls,1 win & 2 nominations.,0,1,2,3
6374,Labyrinth,Nominated for 1 BAFTA Film Award. Another 3 nominations.,0,0,4,4
6375,Lady Jane,,0,0,0,0
6376,9� Weeks,,0,0,0,0
6377,The Fly,Won 1 Oscar. Another 6 wins & 10 nominations.,1,6,10,17
6378,Bullies,1 nomination.,0,0,1,1
6379,The Clan of the Cave Bear,,0,0,0,0
6380,Where the River Runs Black,,0,0,0,0
6381,Youngblood,1 win.,0,1,0,1
6382,Jason Lives: Friday the 13th Part VI,,0,0,0,0
6383,The Delta Force,1 nomination.,0,0,1,1
6384,Howard the Duck,5 wins & 4 nominations.,0,5,4,9
6385,A Fine Mess,,0,0,0,0
6386,Jackals,,0,0,0,0
6387,Hoosiers,Nominated for 2 Oscars. Another 3 wins & 3 nominations.,2,3,3,8
6388,The Golden Child,2 nominations.,0,0,2,2
6389,Witchboard,,0,0,0,0
6390,Wildcats,2 nominations.,0,0,2,2
6391,Down and Out in Beverly Hills,Nominated for 2 Golden Globes. Another 1 win & 3 nominations.,0,1,5,6
6392,Children of a Lesser God,Won 1 Oscar. Another 5 wins & 11 nominations.,1,5,11,17
6393,Armed Response,,0,0,0,0
6394,Ferris Bueller's Day Off,Nominated for 1 Golden Globe. Another 2 wins.,0,2,1,3
6395,The Whoopee Boys,,0,0,0,0
6396,Parting Glances,1 win & 1 nomination.,0,1,1,2
6397,The Whistle Blower,1 nomination.,0,0,1,1
6398,April Fool's Day,,0,0,0,0
6399,Peggy Sue Got Married,Nominated for 3 Oscars. Another 4 wins & 8 nominations.,3,4,8,15
6400,SpaceCamp,1 nomination.,0,0,1,1
6401,Deadly Friend,3 nominations.,0,0,3,3
6402,Armed and Dangerous,,0,0,0,0
6403,Fire with Fire,1 win.,0,1,0,1
6404,The Men's Club,,0,0,0,0
6405,Deadtime Stories,,0,0,0,0
6406,F/X,1 nomination.,0,0,1,1
6407,Extremities,Nominated for 1 Golden Globe. Another 1 win.,0,1,1,2
6408,Platoon,Won 4 Oscars. Another 20 wins & 15 nominations.,4,20,15,39
6409,Betty Blue,Nominated for 1 Oscar. Another 5 wins & 11 nominations.,1,5,11,17
6410,Soul Man,,0,0,0,0
6411,The Manhattan Project,1 win & 1 nomination.,0,1,1,2
6412,Firewalker,,0,0,0,0
6413,When the Wind Blows,1 nomination.,0,0,1,1
6414,On the Edge,1 win & 1 nomination.,0,1,1,2
6415,Nomads,,0,0,0,0
6416,The Longshot,,0,0,0,0
6417,Nothing in Common,1 nomination.,0,0,1,1
6418,Thunder Run,,0,0,0,0
6419,Nutcracker,1 nomination.,0,0,1,1
6420,Dangerously Close,,0,0,0,0
6421,Off Beat,7 wins & 3 nominations.,0,7,3,10
6422,Biggles: Adventures in Time,,0,0,0,0
6423,Big Trouble in Little China,1 win & 1 nomination.,0,1,1,2
6424,Oviri,2 wins & 1 nomination.,0,2,1,3
6425,One Crazy Summer,,0,0,0,0
6426,Flight of the Navigator,4 nominations.,0,0,4,4
6427,One More Saturday Night,,0,0,0,0
6428,Otello,Nominated for 1 Oscar. Another 2 wins & 7 nominations.,1,2,7,10
6429,Star Trek IV: The Voyage Home,Nominated for 4 Oscars. Another 4 wins & 14 nominations.,4,4,14,22
6430,Stand by Me,Nominated for 1 Oscar. Another 5 wins & 10 nominations.,1,5,10,16
6431,Out of Bounds,,0,0,0,0
6432,The Wraith,,0,0,0,0
6433,Police Academy 3: Back in Training,1 win.,0,1,0,1
6434,The Transformers: The Movie,2 nominations.,0,0,2,2
6435,Something Wild,Nominated for 3 Golden Globes. Another 2 wins & 3 nominations.,0,2,6,8
6436,She's Gotta Have It,4 wins & 2 nominations.,0,4,2,6
6437,Eliminators,,0,0,0,0
6438,Sid and Nancy,Nominated for 1 BAFTA Film Award. Another 4 wins & 1 nomination.,0,4,2,6
6439,Reform School Girls,,0,0,0,0
6440,Belizaire the Cajun,3 nominations.,0,0,3,3
6441,Short Circuit,1 win & 3 nominations.,0,1,3,4
6442,Band of the Hand,1 nomination.,0,0,1,1
6443,River's Edge,4 wins & 5 nominations.,0,4,5,9
6444,Shanghai Surprise,1 win & 6 nominations.,0,1,6,7
6445,At Close Range,2 wins & 2 nominations.,0,2,2,4
6446,Duet for One,Nominated for 1 Golden Globe. Another 1 nomination.,0,0,2,2
6447,Ruthless People,1 win & 3 nominations.,0,1,3,4
6448,Sacrifice,,0,0,0,0
6449,Scene of the Crime,1 nomination.,0,0,1,1
6450,Down by Law,4 wins & 6 nominations.,0,4,6,10
6451,Raw Deal,,0,0,0,0
6452,Detective School Dropouts,,0,0,0,0
6453,Desert Bloom,1 win.,0,1,0,1
6454,Back to School,1 win & 2 nominations.,0,1,2,3
6455,Every Time We Say Goodbye,,0,0,0,0
6456,Pretty in Pink,1 win.,0,1,0,1
6457,The Mission,Won 1 Oscar. Another 14 wins & 27 nominations.,1,14,27,42
6458,The Texas Chainsaw Massacre 2,1 win & 1 nomination.,0,1,1,2
6459,Solarbabies,1 nomination.,0,0,1,1
6460,The Money Pit,,0,0,0,0
6461,The Morning After,,0,0,0,0
6462,The Mosquito Coast,Nominated for 2 Golden Globes. Another 1 win & 1 nomination.,0,1,3,4
6463,Psicosis III,,0,0,0,0
6464,Defense of the Realm,Won 1 BAFTA Film Award. Another 6 wins & 2 nominations.,0,7,2,9
6465,Avenging Force,,0,0,0,0
6466,The Naked Cage,,0,0,0,0
6467,The Name of the Rose,Won 2 BAFTA Film Awards. Another 15 wins & 6 nominations.,0,17,6,23
6468,Quicksilver,,0,0,0,0
6469,Quiet Cool,,0,0,0,0
6470,Rad,1 win & 1 nomination.,0,1,1,2
6471,Sky Bandits,,0,0,0,0
6472,An American Tail,Nominated for 1 Oscar. Another 6 wins & 6 nominations.,1,6,6,13
6473,"No Retreat, No Surrender",,0,0,0,0
6474,Malcolm,9 wins.,0,9,0,9
6475,Haunted Honeymoon,1 win.,0,1,0,1
6476,Low Blow,,0,0,0,0
6477,Lucas,3 nominations.,0,0,3,3
6478,The Assault,,0,0,0,0
6479,Violets Are Blue...,,0,0,0,0
6480,Hardbodies 2,,0,0,0,0
6481,Born American,,0,0,0,0
6482,Hannah and Her Sisters,Won 3 Oscars. Another 24 wins & 26 nominations.,3,24,26,53
6483,The Adventures of Milo and Otis,1 win & 2 nominations.,0,1,2,3
6484,Body Slam,,0,0,0,0
6485,Man Facing Southeast,13 wins & 2 nominations.,0,13,2,15
6486,Vamp,2 nominations.,0,0,2,2
6487,About Last Night...,1 nomination.,0,0,1,1
6488,Manhunter,1 win & 1 nomination.,0,1,1,2
6489,Half Moon Street,1 win & 1 nomination.,0,1,1,2
6490,Absolute Beginners,,0,0,0,0
6491,Manon of the Spring,Nominated for 1 BAFTA Film Award. Another 4 wins & 2 nominations.,0,4,3,7
6492,Gung Ho,1 win.,0,1,0,1
6493,Cobra,6 nominations.,0,0,6,6
6494,Club Paradise,1 nomination.,0,0,1,1
6495,Clockwise,1 win.,0,1,0,1
6496,Highlander,,0,0,0,0
6497,Brighton Beach Memoirs,,0,0,0,0
6498,The Boy in Blue,3 nominations.,0,0,3,3
6499,Legal Eagles,1 win.,0,1,0,1
6500,Let's Get Harry,,0,0,0,0
6501,The Boy Who Could Fly,3 wins & 5 nominations.,0,3,5,8
6502,A Man and a Woman: 20 Years Later,,0,0,0,0
6503,Henry: Portrait of a Serial Killer,9 wins & 8 nominations.,0,9,8,17
6504,Weekend Warriors,,0,0,0,0
6505,Link,1 win & 2 nominations.,0,1,2,3
6506,Little Shop of Horrors,Nominated for 2 Oscars. Another 2 wins & 12 nominations.,2,2,12,16
6507,Heathcliff: The Movie,,0,0,0,0
6508,Heartburn,1 win & 1 nomination.,0,1,1,2
6509,The Big Easy,4 wins & 4 nominations.,0,4,4,8
6510,The Best of Times,,0,0,0,0
6511,Heartbreak Ridge,Nominated for 1 Oscar. Another 3 wins.,1,3,0,4
6512,That's Life!,4 nominations.,0,0,4,4
6513,Matador,6 wins & 6 nominations.,0,6,6,12
6514,No Mercy,1 win & 1 nomination.,0,1,1,2
6515,M�nage,,0,0,0,0
6516,Murphy's Law,,0,0,0,0
6517,Sweet Liberty,,0,0,0,0
6518,Troll,1 nomination.,0,0,1,1
6519,My Chauffeur,,0,0,0,0
6520,Trick or Treat,,0,0,0,0
6521,My Little Pony: The Movie,4 wins & 6 nominations.,0,4,6,10
6522,American Anthem,1 nomination.,0,0,1,1
6523,Black Moon Rising,1 nomination.,0,0,1,1
6524,Mauvais Sang,,0,0,0,0
6525,Native Son,4 wins & 6 nominations.,0,4,6,10
6526,From Beyond,3 wins & 3 nominations.,0,3,3,6
6527,Tough Guys,,0,0,0,0
6528,Touch and Go,,0,0,0,0
6529,Summer,5 wins.,0,5,0,5
6530,Top Gun,Won 1 Oscar. Another 10 wins & 5 nominations.,1,10,5,16
6531,Streets of Gold,,0,0,0,0
6532,Night of the Creeps,1 win.,0,1,0,1
6533,True Stories,1 win & 2 nominations.,0,1,2,3
6534,Crocodile Dundee,Nominated for 1 Oscar. Another 3 wins & 7 nominations.,1,3,7,11
6535,The Ladies Club,,0,0,0,0
6536,Allan Quatermain and the Lost City of Gold,1 nomination.,0,0,1,1
6537,Maximum Overdrive,4 nominations.,0,0,4,4
6538,TerrorVision,1 nomination.,0,0,1,1
6539,Meatballs III: Summer Job,,0,0,0,0
6540,Blue Velvet,Nominated for 1 Oscar. Another 18 wins & 17 nominations.,1,18,17,36
6541,Blue City,5 nominations.,0,0,5,5
6542,Under the Cherry Moon,5 wins & 4 nominations.,0,5,4,9
6543,Gothic,2 wins & 1 nomination.,0,2,1,3
6544,GoBots: Battle of the Rock Lords,,0,0,0,0
6545,Aliens,Won 2 Oscars. Another 18 wins & 23 nominations.,2,18,23,43
6546,Tai-Pan,2 nominations.,0,0,2,2
6547,'Round Midnight,Won 1 Oscar. Another 10 wins & 12 nominations.,1,10,12,23
6548,Crimes of the Heart,Nominated for 3 Oscars. Another 3 wins & 1 nomination.,3,3,1,7
6549,Modern Girls,,0,0,0,0
6550,The Karate Kid Part II,Nominated for 1 Oscar. Another 4 wins & 2 nominations.,1,4,2,7
6551,Mona Lisa,Nominated for 1 Oscar. Another 14 wins & 13 nominations.,1,14,13,28
6552,Ginger and Fred,Nominated for 1 Golden Globe. Another 18 wins & 17 nominations.,0,18,18,36
6553,Critters,3 nominations.,0,0,3,3
6554,Poltergeist II: The Other Side,Nominated for 1 Oscar. Another 1 win & 4 nominations.,1,1,4,6
