name,awards,oscar_wins_and_nominations,other_wins,other_nominations,total_awards_and_nominations
Doctor Strange,Nominated for 1 Oscar. Another 19 wins & 67 nominations.,1,19,67,87
Sleight,3 nominations.,0,0,3,3
Silence,Nominated for 1 Oscar. Another 6 wins & 56 nominations.,1,6,56,63
Manchester by the Sea,Won 2 Oscars. Another 127 wins & 263 nominations.,2,127,263,392
Dirty Grandpa,2 wins & 11 nominations,0,2,11,13
Manos de piedra,,0,0,0,0
Jackie,Nominated for 3 Oscars. 44 wins & 166 nominations total,3,44,166,213
Hunt for the Wilderpeople,22 wins & 25 nominations.,0,22,25,47
Lady Macbeth,Nominated for 2 BAFTA Film Awards. Another 21 wins & 51 nominations.,0,21,53,74
Don't Breathe,7 wins & 21 nominations,0,7,21,28
Absolutely Fabulous: The Movie,1 win & 7 nominations.,0,1,7,8
Bad Moms,3 wins & 5 nominations,0,3,5,8
Sing street; este es tu momento,,0,0,0,0
Denial,Nominated for 1 BAFTA Film Award. Another 5 nominations.,0,0,6,6
Allied,Nominated for 1 Oscar. Another 2 wins & 9 nominations.,1,2,9,12
Underworld: Blood Wars,,0,0,0,0
Ice Age: Collision Course,2 wins.,0,2,0,2
Storks,5 wins & 4 nominations,0,5,4,9
The Purge: Election Year,6 nominations,0,0,6,6
Horizonte profundo,,0,0,0,0
Star Trek Beyond,Nominated for 1 Oscar. Another 3 wins & 28 nominations.,1,3,28,32
Alice Through the Looking Glass,4 wins & 20 nominations,0,4,20,24
Split,9 wins & 24 nominations,0,9,24,33
Deadpool,28 wins & 78 nominations.,0,28,78,106
Bleed for This,1 win & 3 nominations,0,1,3,4
Sola contra el poder,,0,0,0,0
Snowden,4 wins & 7 nominations,0,4,7,11
Kung Fu Panda 3,1 win & 10 nominations.,0,1,10,11
Jason Bourne,3 wins & 20 nominations.,0,3,20,23
Jack Reacher: Sin regreso,,0,0,0,0
"Hail, Caesar!",Nominated for 1 Oscar. Another 13 wins & 43 nominations.,1,13,43,57
The Legend of Tarzan,2 wins & 4 nominations.,0,2,4,6
Maudie,24 wins & 17 nominations.,0,24,17,41
Meet the Blacks,,0,0,0,0
El beb� de Bridget Jones,,0,0,0,0
El cliente,,0,0,0,0
Resident Evil: The Final Chapter,2 wins & 3 nominations.,0,2,3,5
Keeping Up with the Joneses,3 nominations,0,0,3,3
El demonio ne�n,,0,0,0,0
El especialista: La resurrecci�n,,0,0,0,0
El fin del sue�o americano,,0,0,0,0
War Dogs,3 nominations.,0,0,3,3
Warcraft: The Beginning,,0,0,0,0
Ella es un monstruo,,0,0,0,0
A Monster Calls,39 wins & 56 nominations.,0,39,56,95
Mi pap� es un gato,,0,0,0,0
Billy Lynn's Long Halftime Walk,2 wins & 8 nominations.,0,2,8,10
In a Valley of Violence,,0,0,0,0
Wakefield,1 win & 1 nomination,0,1,1,2
Risen,3 nominations,0,0,3,3
Rogue One,Nominated for 2 Oscars. Another 24 wins & 81 nominations.,2,24,81,107
Sausage Party,1 win & 26 nominations.,0,1,26,27
The Shallows,1 win & 15 nominations,0,1,15,16
Max Steel,,0,0,0,0
Me Before You,6 wins & 6 nominations,0,6,6,12
Rules Don't Apply,3 wins & 10 nominations,0,3,10,13
Bad Santa 2,1 win & 2 nominations,0,1,2,3
D�a del atentado,,0,0,0,0
Eddie the Eagle,2 wins & 9 nominations,0,2,9,11
Kubo and the Two Strings,Nominated for 2 Oscars. Another 33 wins & 65 nominations.,2,33,65,100
A United Kingdom,3 wins & 5 nominations.,0,3,5,8
The Light Between Oceans,1 win & 16 nominations,0,1,16,17
Keanu,4 wins & 5 nominations,0,4,5,9
Allegiant,3 wins & 12 nominations.,0,3,12,15
Almost Christmas,3 nominations.,0,0,3,3
Middle School: The Worst Years of My Life,5 nominations.,0,0,5,5
La tortuga roja,,0,0,0,0
The Disappointments Room,1 nomination.,0,0,1,1
The Hollars,1 win & 5 nominations,0,1,5,6
Hidden Figures,Nominated for 3 Oscars. Another 36 wins & 91 nominations.,3,36,91,130
Anthropoid,1 win & 16 nominations.,0,1,16,17
Central Intelligence,2 wins & 8 nominations.,0,2,8,10
Certain Women,11 wins & 49 nominations.,0,11,49,60
The Darkness,,0,0,0,0
The Conjuring 2,4 wins & 13 nominations,0,4,13,17
The Comedian,1 win,0,1,0,1
Their Finest,1 win & 8 nominations.,0,1,8,9
Lights Out,3 wins & 9 nominations,0,3,9,12
The Choice,3 nominations,0,0,3,3
The Brothers Grimsby,,0,0,0,0
The Boy,6 nominations,0,0,6,6
The Edge of Seventeen,8 wins & 29 nominations.,0,8,29,37
Leap!,,0,0,0,0
Suicide Squad,Won 1 Oscar. 17 wins & 40 nominations total,1,17,40,58
Captain Fantastic,Nominated for 1 Oscar. Another 15 wins & 49 nominations.,1,15,49,65
The Girl on the Train,Nominated for 1 BAFTA Film Award. Another 4 wins & 12 nominations.,0,4,13,17
Assassin's Creed,2 wins & 1 nomination.,0,2,1,3
The Founder,1 win & 5 nominations.,0,1,5,6
The Forest,1 win & 1 nomination,0,1,1,2
The Finest Hours,2 wins.,0,2,0,2
Caf� Society,,0,0,0,0
Arrival,Won 1 Oscar. Another 64 wins & 263 nominations.,1,64,263,328
The Eyes of My Mother,5 wins & 14 nominations.,0,5,14,19
La vida secreta de tus mascotas,,0,0,0,0
Captain America: Civil War,16 wins & 72 nominations.,0,16,72,88
The Exception,2 nominations.,0,0,2,2
The Boss,3 nominations.,0,0,3,3
The Birth of a Nation,2 wins,0,2,0,2
Lion,Nominated for 6 Oscars. Another 58 wins & 103 nominations.,6,58,103,167
The Belko Experiment,,0,0,0,0
Teenage Mutant Ninja Turtles: Out of the Shadows,10 nominations.,0,0,10,10
La La Land,Won 6 Oscars. Another 236 wins & 287 nominations.,6,236,287,529
Los ilusionistas 2,,0,0,0,0
American Honey,Nominated for 1 BAFTA Film Award. Another 13 wins & 43 nominations.,0,13,44,57
Triple 9,4 nominations.,0,0,4,4
The Jungle Book,Won 1 Oscar. Another 32 wins & 54 nominations.,1,32,54,87
"I, Daniel Blake",30 wins & 38 nominations total,0,30,38,68
Love & Friendship,2 wins & 1 nomination.,0,2,1,3
Trolls,Nominated for 1 Oscar. Another 4 wins & 35 nominations.,1,4,35,40
Criminal,,0,0,0,0
Swiss Army Man,8 wins & 30 nominations,0,8,30,38
Loving,Nominated for 1 Oscar. 24 wins & 89 nominations total,1,24,89,114
Lowriders,5 nominations.,0,0,5,5
Hasta el �ltimo hombre,,0,0,0,0
Sully,Nominated for 1 Oscar. 14 wins & 36 nominations total,1,14,36,51
London Has Fallen,1 win & 2 nominations.,0,1,2,3
La bruja de Blair,,0,0,0,0
The Infiltrator,1 nomination.,0,0,1,1
Boo! A Madea Halloween,6 nominations.,0,0,6,6
The Huntsman: Winter's War,16 nominations.,0,0,16,16
The Bad Batch,1 win & 3 nominations.,0,1,3,4
The Take,,0,0,0,0
The BFG,4 wins & 26 nominations.,0,4,26,30
Hell or High Water,Nominated for 4 Oscars. 46 wins & 171 nominations total,4,46,171,221
Collateral Beauty,1 win & 6 nominations.,0,1,6,7
The 5th Wave,1 nomination.,0,0,1,1
Collide,1 win & 1 nomination.,0,1,1,2
The Angry Birds Movie,1 win & 3 nominations.,0,1,3,4
Live by Night,3 nominations.,0,0,3,3
Complete Unknown,1 win & 4 nominations.,0,1,4,5
Toni Erdmann,Nominated for 1 Oscar. Another 58 wins & 83 nominations.,1,58,83,142
The Accountant,3 wins & 5 nominations.,0,3,5,8
The Lost City of Z,6 wins & 31 nominations.,0,6,31,37
The Great Wall,3 wins & 2 nominations.,0,3,2,5
Fantastic Beasts and Where to Find Them,Won 1 Oscar. Another 14 wins & 54 nominations.,1,14,54,69
Whiskey Tango Foxtrot,1 nomination,0,0,1,1
Kingsglaive: Final Fantasy XV,2 nominations,0,0,2,2
Fences,Won 1 Oscar. Another 56 wins & 120 nominations.,1,56,120,177
Inferno,4 wins & 1 nomination,0,4,1,5
Paterson,10 wins & 43 nominations.,0,10,43,53
Ghostbusters,Nominated for 2 Oscars. Another 7 wins & 6 nominations.,2,7,6,15
From the Land of the Moon,,0,0,0,0
Nerve,5 nominations.,0,0,5,5
Office Christmas Party,1 win & 1 nomination.,0,1,1,2
Popstar: Never Stop Never Stopping,1 win & 6 nominations,0,1,6,7
Miss Peregrine's Home for Peculiar Children,2 wins & 12 nominations.,0,2,12,14
Morgan,2 nominations.,0,0,2,2
Neighbors 2: Sorority Rising,3 wins & 5 nominations,0,3,5,8
Presencia siniestra,,0,0,0,0
Independence Day: Resurgence,3 wins & 17 nominations,0,3,17,20
A Hologram for the King,2 wins & 3 nominations.,0,2,3,5
Ben-Hur,Won 11 Oscars. Another 18 wins & 16 nominations.,11,18,16,45
Florence Foster Jenkins,Nominated for 2 Oscars. Another 10 wins & 45 nominations.,2,10,45,57
Gold,1 win & 5 nominations.,0,1,5,6
Moana,Nominated for 2 Oscars. 20 wins & 90 nominations total,2,20,90,112
Frantz,7 wins & 35 nominations.,0,7,35,42
Mothers and Daughters,1 win & 2 nominations,0,1,2,3
Indignation,8 nominations,0,0,8,8
Personal Shopper,9 wins & 24 nominations.,0,9,24,33
Free Fire,3 wins & 9 nominations,0,3,9,12
Pet,4 nominations,0,0,4,4
Pete's Dragon,3 wins & 7 nominations,0,3,7,10
Batman v Superman: Dawn of Justice,14 wins & 33 nominations.,0,14,33,47
Why Him?,1 win,0,1,0,1
Your name,,0,0,0,0
A Cure for Wellness,4 wins & 5 nominations.,0,4,5,9
Gods of Egypt,2 wins & 14 nominations.,0,2,14,16
20th Century Women,Nominated for 1 Oscar. Another 12 wins & 72 nominations.,1,12,72,85
Mother's Day,1 win & 6 nominations,0,1,6,7
Free State of Jones,3 wins & 4 nominations,0,3,4,7
Norman,1 win & 1 nomination.,0,1,1,2
The Other Side of the Door,2 wins & 3 nominations.,0,2,3,5
Neruda,Nominated for 1 Golden Globe. Another 11 wins & 35 nominations.,0,11,36,47
13 Hours,Nominated for 1 Oscar. 5 nominations total,0,1,5,6
Batman: The Killing Joke,1 win & 2 nominations.,0,1,2,3
Zootopia,Won 1 Oscar. Another 46 wins & 72 nominations.,1,46,72,119
Genius,1 win & 6 nominations.,0,1,6,7
The Magnificent Seven,5 wins & 12 nominations.,0,5,12,17
Ouija: Origin of Evil,2 wins & 7 nominations,0,2,7,9
My Big Fat Greek Wedding 2,3 nominations.,0,0,3,3
Finding Dory,Nominated for 1 BAFTA Film Award. Another 17 wins & 45 nominations.,0,17,46,63
31,2 wins & 8 nominations,0,2,8,10
The Nice Guys,9 wins & 34 nominations,0,9,34,43
10 Cloverfield Lane,16 wins & 48 nominations.,0,16,48,64
Our Kind of Traitor,4 nominations.,0,0,4,4
Midnight Special,3 wins & 14 nominations.,0,3,14,17
Goat,5 nominations,0,0,5,5
Moonlight,Won 3 Oscars. Another 219 wins & 292 nominations.,3,219,292,514
How to Be Single,3 nominations,0,0,3,3
Monster Trucks,2 nominations.,0,0,2,2
Mike and Dave Need Wedding Dates,4 nominations,0,0,4,4
Miracles from Heaven,2 wins & 5 nominations.,0,2,5,7
Nocturnal Animals,Nominated for 1 Oscar. Another 21 wins & 150 nominations.,1,21,150,172
Money Monster,2 nominations.,0,0,2,2
Zoolander 2,7 wins & 17 nominations.,0,7,17,24
Incarnate,,0,0,0,0
Pride and Prejudice and Zombies,1 win & 3 nominations,0,1,3,4
Mr. Church,3 nominations.,0,0,3,3
Paris Can Wait,,0,0,0,0
X-Men: Apocalypse,1 win & 19 nominations.,0,1,19,20
Everybody Wants Some!!,2 wins & 17 nominations,0,2,17,19
The Stanford Prison Experiment,4 wins & 3 nominations.,0,4,3,7
Youth,Nominated for 1 Oscar. Another 24 wins & 57 nominations.,1,24,57,82
True Story,4 nominations.,0,0,4,4
Synchronicity,1 win & 1 nomination.,0,1,1,2
Crimson Peak,6 wins & 42 nominations.,0,6,42,48
Knight of Cups,4 wins & 9 nominations,0,4,9,13
Insurgent,4 wins & 17 nominations.,0,4,17,21
Los 33,,0,0,0,0
Crimenes ocultos,,0,0,0,0
Joy,Nominated for 1 Oscar. Another 8 wins & 22 nominations.,1,8,22,31
Our Brand Is Crisis,2 nominations,0,0,2,2
Mortdecai,1 win & 9 nominations.,0,1,9,10
Terminator Genisys,10 nominations.,0,0,10,10
American Ultra,,0,0,0,0
Into the Forest,2 wins & 3 nominations.,0,2,3,5
Creed,Nominated for 1 Oscar. 44 wins & 65 nominations total,1,44,65,110
Tale of Tales,21 wins & 15 nominations.,0,21,15,36
Focus,3 nominations.,0,0,3,3
I'll See You in My Dreams,8 nominations,0,0,8,8
Conspiraci�n y poder,,0,0,0,0
Ted 2,3 wins & 4 nominations.,0,3,4,7
Cop Car,1 win & 4 nominations,0,1,4,5
Tomorrowland,2 wins & 19 nominations.,0,2,19,21
Tangerine,25 wins & 43 nominations,0,25,43,68
The Age of Adaline,1 win & 10 nominations,0,1,10,11
The Intern,1 win & 8 nominations,0,1,8,9
3 Generations,1 nomination,0,0,1,1
Cinderella,Nominated for 1 Oscar. 8 wins & 37 nominations total,1,8,37,46
The Overnight,1 win & 3 nominations.,0,1,3,4
Jurassic World,15 wins & 58 nominations.,0,15,58,73
The Wedding Ringer,2 wins & 4 nominations.,0,2,4,6
The Perfect Guy,2 wins & 3 nominations.,0,2,3,5
Captive,3 nominations,0,0,3,3
Jupiter Ascending,4 wins & 16 nominations.,0,4,16,20
Home,3 wins & 9 nominations.,0,3,9,12
Furious 7,35 wins & 36 nominations.,0,35,36,71
High-Rise,6 wins & 14 nominations.,0,6,14,20
The Hateful Eight,Won 1 Oscar. 43 wins & 116 nominations total,1,43,116,160
The Walk,3 wins & 17 nominations,0,3,17,20
Mr. Holmes,19 nominations.,0,0,19,19
The Family Fang,1 win & 1 nomination.,0,1,1,2
La �ltima ola,,0,0,0,0
M�s fuerte que las bombas,,0,0,0,0
The Visit,1 win & 14 nominations.,0,1,14,15
"Hello, My Name Is Doris",2 wins & 11 nominations.,0,2,11,13
The Vatican Tapes,,0,0,0,0
Mustang: belleza salvaje,,0,0,0,0
Bridge of Spies,Won 1 Oscar. Another 29 wins & 103 nominations.,1,29,103,133
The Gunman,1 nomination.,0,0,1,1
Mr. Right,2 nominations.,0,0,2,2
Get Hard,2 nominations.,0,0,2,2
Burnt,6 wins & 1 nomination,0,6,1,7
The Good Dinosaur,9 wins & 41 nominations.,0,9,41,50
Hitman: Agent 47,2 nominations.,0,0,2,2
Brooklyn,Nominated for 3 Oscars. Another 38 wins & 158 nominations.,3,38,158,199
The End of the Tour,4 wins & 18 nominations,0,4,18,22
Carol,Nominated for 6 Oscars. Another 77 wins & 248 nominations.,6,77,248,331
La noche del demonio: Capitulo 3,,0,0,0,0
The Dressmaker,15 wins & 41 nominations.,0,15,41,56
La habitaci�n,,0,0,0,0
The Big Short,Won 1 Oscar. Another 36 wins & 81 nominations.,1,36,81,118
Z for Zachariah,3 nominations.,0,0,3,3
The Blackcoat's Daughter,6 nominations.,0,0,6,6
The Hunger Games: Mockingjay - Part 2,16 wins & 34 nominations,0,16,34,50
The Boy Next Door,1 win & 6 nominations.,0,1,6,7
I Saw the Light,,0,0,0,0
The Bronze,1 nomination.,0,0,1,1
Alvin and the Chipmunks: The Road Chip,1 win & 4 nominations,0,1,4,5
Freeheld,1 win & 10 nominations.,0,1,10,11
Born to Be Blue,3 wins & 7 nominations.,0,3,7,10
Chi-Raq,4 wins & 14 nominations,0,4,14,18
Avengers: Age of Ultron,8 wins & 49 nominations,0,8,49,57
Frente al mar,,0,0,0,0
Anomalisa,Nominated for 1 Oscar. 25 wins & 79 nominations total,1,25,79,105
La langosta,,0,0,0,0
The D Train,2 nominations.,0,0,2,2
The DUFF,1 win & 8 nominations.,0,1,8,9
Chappie,3 nominations.,0,0,3,3
The Danish Girl,Won 1 Oscar. Another 30 wins & 79 nominations.,1,30,79,110
Ant-Man,Nominated for 1 BAFTA Film Award. Another 4 wins & 33 nominations.,0,4,34,38
The Diary of a Teenage Girl,16 wins & 37 nominations,0,16,37,53
The Peanuts Movie,Nominated for 1 Golden Globe. Another 2 wins & 47 nominations.,0,2,48,50
Legend,6 wins & 12 nominations.,0,6,12,18
The Witch,,0,0,0,0
Love the Coopers,2 nominations,0,0,2,2
Aloha,2 wins & 7 nominations.,0,2,7,9
The Night Before,2 nominations.,0,0,2,2
Run All Night,,0,0,0,0
Poltergeist,Nominated for 3 Oscars. Another 4 wins & 4 nominations.,3,4,4,11
Maze Runner: The Scorch Trials,2 wins & 5 nominations.,0,2,5,7
"McFarland, USA",4 wins & 3 nominations,0,4,3,7
The Martian,Nominated for 7 Oscars. Another 38 wins & 193 nominations.,7,38,193,238
Rock the Kasbah,,0,0,0,0
In the Heart of the Sea,1 win & 5 nominations,0,1,5,6
A Walk in the Woods,1 nomination,0,0,1,1
Victor Frankenstein,4 wins & 1 nomination.,0,4,1,5
Me and Earl and the Dying Girl,18 wins & 30 nominations,0,18,30,48
Eye in the Sky,3 wins & 10 nominations.,0,3,10,13
Experimenter,3 wins & 5 nominations.,0,3,5,8
San Andreas,2 wins & 10 nominations.,0,2,10,12
Pixels,5 wins & 9 nominations.,0,5,9,14
Dragon Blade,4 wins & 2 nominations.,0,4,2,6
Vacation,1 win & 3 nominations.,0,1,3,4
Pitch Perfect 2,9 wins & 16 nominations.,0,9,16,25
Miss You Already,1 nomination.,0,0,1,1
Scouts Guide to the Zombie Apocalypse,5 nominations.,0,0,5,5
Secret in Their Eyes,2 wins & 3 nominations,0,2,3,5
Dope,5 wins & 24 nominations,0,5,24,29
45 Years,Nominated for 1 Oscar. Another 22 wins & 61 nominations.,1,22,61,84
Black Mass,6 wins & 24 nominations.,0,6,24,30
Far from the Madding Crowd,2 wins & 12 nominations,0,2,12,14
The Lazarus Effect,2 nominations,0,0,2,2
The Last Witch Hunter,1 nomination.,0,0,1,1
The Man from U.N.C.L.E.,7 wins & 5 nominations,0,7,5,12
Ip Man 3,5 wins & 21 nominations.,0,5,21,26
Mississippi Grind,2 wins & 3 nominations.,0,2,3,5
Remember,6 wins & 24 nominations,0,6,24,30
Krisha,16 wins & 28 nominations,0,16,28,44
El principito,,0,0,0,0
The Second Best Exotic Marigold Hotel,4 nominations.,0,0,4,4
Green Room,8 wins & 25 nominations,0,8,25,33
El transportador recargado,,0,0,0,0
The Sea of Trees,2 nominations,0,0,2,2
Krampus,4 wins & 14 nominations,0,4,14,18
Misi�n: imposible 5 - Naci�n secreta,,0,0,0,0
Regression,1 win & 2 nominations.,0,1,2,3
Esta chica es un desastre,,0,0,0,0
We Are Your Friends,,0,0,0,0
Equals,1 win & 5 nominations,0,1,5,6
The Longest Ride,1 win & 5 nominations,0,1,5,6
War Room,5 wins,0,5,0,5
El hijo de Sa�l,,0,0,0,0
El gran peque�o,,0,0,0,0
Minions,Nominated for 1 BAFTA Film Award. Another 4 wins & 26 nominations.,0,4,27,31
Goosebumps,4 nominations,0,0,4,4
Hotel Transylvania 2,1 win & 10 nominations.,0,1,10,11
The Man Who Knew Infinity,1 win & 3 nominations,0,1,3,4
Everest,1 win & 8 nominations.,0,1,8,9
Revancha,,0,0,0,0
Revenant: El Renacido,,0,0,0,0
Ricki and the Flash,4 nominations,0,0,4,4
Project Almanac,,0,0,0,0
Hot Tub Time Machine 2,2 nominations.,0,0,2,2
Irrational Man,3 nominations,0,0,3,3
Bajo la arena,,0,0,0,0
Shaun the Sheep Movie,Nominated for 1 Oscar. 5 wins & 50 nominations total,1,5,50,56
Self/less,,0,0,0,0
Woman in Gold,6 nominations.,0,0,6,6
Straight Outta Compton,Nominated for 1 Oscar. 28 wins & 40 nominations total,1,28,40,69
Paul Blart: Mall Cop 2,1 win & 9 nominations.,0,1,9,10
Magic Mike XXL,2 wins & 5 nominations.,0,2,5,7
Jem and the Holograms,2 nominations,0,0,2,2
Paranormal Activity: The Ghost Dimension,1 win & 4 nominations,0,1,4,5
Maggie's Plan,1 win & 9 nominations.,0,1,9,10
Maggie,1 win & 4 nominations.,0,1,4,5
Strangerland,1 win & 6 nominations.,0,1,6,7
Strange Magic,1 win & 4 nominations.,0,1,4,5
Hardcore: Misi�n extrema,,0,0,0,0
Spectre,Won 1 Oscar. Another 7 wins & 37 nominations.,1,7,37,45
Macbeth,4 wins & 30 nominations.,0,4,30,34
Inside Out,Won 1 Oscar. Another 99 wins & 116 nominations.,1,99,116,216
Danny Collins,1 win & 4 nominations.,0,1,4,5
Steve Jobs,Nominated for 2 Oscars. Another 28 wins & 112 nominations.,2,28,112,142
Una historia de amor y oscuridad,,0,0,0,0
Mad Max: Fury Road,Won 6 Oscars. Another 239 wins & 231 nominations.,6,239,231,476
Knock Knock,,0,0,0,0
Spotlight,Won 2 Oscars. 124 wins & 143 nominations total,2,124,143,269
Star Wars: The Force Awakens,,0,0,0,0
Spy,Nominated for 2 Golden Globes. Another 6 wins & 28 nominations.,0,6,30,36
Fifty Shades of Grey,Nominated for 1 Oscar. Another 9 wins & 27 nominations.,1,9,27,37
The Lady in the Van,1 win & 8 nominations total,0,1,8,9
Jenny's Wedding,1 nomination,0,0,1,1
Un hombre gru��n,,0,0,0,0
Daddy's Home,1 win & 4 nominations.,0,1,4,5
Unfinished Business,1 nomination,0,0,1,1
The SpongeBob Movie: Sponge Out of Water,1 win & 9 nominations.,0,1,9,10
Mistress America,2 wins & 14 nominations,0,2,14,16
Sicario,Nominated for 3 Oscars. 15 wins & 158 nominations total,3,15,158,176
The Meddler,6 nominations,0,0,6,6
Pan,8 nominations,0,0,8,8
A Bigger Splash,4 wins & 19 nominations,0,4,19,23
Sinister 2,1 win & 3 nominations.,0,1,3,4
Sisters,4 nominations.,0,0,4,4
Desierto,2 wins & 21 nominations.,0,2,21,23
90 Minutes in Heaven,,0,0,0,0
Sleeping with Other People,2 nominations.,0,0,2,2
Trumbo,Nominated for 1 Oscar. Another 8 wins & 44 nominations.,1,8,44,53
Paper Towns,4 wins & 3 nominations.,0,4,3,7
Slow West,7 wins & 20 nominations.,0,7,20,27
Suffragette,17 wins & 20 nominations.,0,17,20,37
Jane Got a Gun,1 nomination,0,0,1,1
Demolition,1 win & 2 nominations.,0,1,2,3
Blackhat,1 win & 5 nominations,0,1,5,6
Blackway,,0,0,0,0
The Judge,Nominated for 1 Oscar. Another 3 wins & 8 nominations.,1,3,8,12
The Keeping Room,3 wins & 8 nominations,0,3,8,11
The November Man,,0,0,0,0
The Guest,4 wins & 13 nominations.,0,4,13,17
Horrible Bosses 2,1 win & 3 nominations.,0,1,3,4
Before I Go to Sleep,,0,0,0,0
The Hunger Games: Mockingjay - Part 1,21 wins & 32 nominations.,0,21,32,53
Honeymoon,5 nominations.,0,0,5,5
Before We Go,,0,0,0,0
Birdman or (The Unexpected Virtue of Ignorance),Won 4 Oscars. Another 189 wins & 291 nominations.,4,189,291,484
Black Sea,,0,0,0,0
Beyond the Lights,Nominated for 1 Oscar. Another 4 wins & 25 nominations.,1,4,25,30
The Hundred-Foot Journey,2 wins & 4 nominations.,0,2,4,6
The Legend of Hercules,1 win & 7 nominations.,0,1,7,8
The Monuments Men,3 wins & 3 nominations.,0,3,3,6
The Homesman,5 wins & 14 nominations.,0,5,14,19
The Other Woman,3 wins & 5 nominations,0,3,5,8
The Maze Runner,4 wins & 12 nominations.,0,4,12,16
Boyhood,Won 1 Oscar. Another 172 wins & 218 nominations.,1,172,218,391
The Lego Movie,Nominated for 1 Oscar. Another 72 wins & 66 nominations.,1,72,66,139
The Hobbit: The Battle of the Five Armies,Nominated for 1 Oscar. Another 8 wins & 54 nominations.,1,8,54,63
The Last Five Years,1 win & 1 nomination.,0,1,1,2
La salvaci�n,,0,0,0,0
The One I Love,2 wins & 2 nominations.,0,2,2,4
Big Eyes,Won 1 Golden Globe. Another 2 wins & 18 nominations.,0,3,18,21
Kingsman: The Secret Service,10 wins & 32 nominations.,0,10,32,42
Big Game,1 win & 8 nominations.,0,1,8,9
The Imitation Game,Won 1 Oscar. Another 48 wins & 162 nominations.,1,48,162,211
Big Hero 6,Won 1 Oscar. Another 16 wins & 58 nominations.,1,16,58,75
Blended,1 win & 10 nominations,0,1,10,11
The Interview,1 win & 6 nominations.,0,1,6,7
'71,Nominated for 1 BAFTA Film Award. Another 13 wins & 30 nominations.,0,13,31,44
Still Alice,Won 1 Oscar. 34 wins & 35 nominations total,1,34,35,70
Laggies,1 win & 1 nomination,0,1,1,2
El penthouse,,0,0,0,0
Exodus: Gods and Kings,5 nominations.,0,0,5,5
Ex Machina,Won 1 Oscar. Another 72 wins & 161 nominations.,1,72,161,234
Promesa de Vida,,0,0,0,0
Goodnight Mommy,22 wins & 36 nominations.,0,22,36,58
Million Dollar Arm,1 win & 2 nominations.,0,1,2,3
Escobar,1 nomination.,0,0,1,1
Entrevista con unos vampiros,,0,0,0,0
Enredos en Broadway,,0,0,0,0
Endless Love,1 win.,0,1,0,1
Relatos salvajes,,0,0,0,0
"Men, Women & Children",,0,0,0,0
El recuerdo de Marnie,,0,0,0,0
El payaso del mal,,0,0,0,0
The Grand Budapest Hotel,Won 4 Oscars. Another 130 wins & 226 nominations.,4,130,226,360
El dador de recuerdos,,0,0,0,0
Ride Along,1 win & 7 nominations.,0,1,7,8
Rio 2,2 wins & 24 nominations.,0,2,24,26
Edge of Tomorrow,11 wins & 38 nominations.,0,11,38,49
Earth to Echo,2 wins & 1 nomination.,0,2,1,3
Guardians of the Galaxy,Nominated for 2 Oscars. Another 52 wins & 100 nominations.,2,52,100,154
Dumb and Dumber To,1 win & 7 nominations,0,1,7,8
Rudderless,1 win & 1 nomination.,0,1,1,2
Sabotage,2 wins & 5 nominations,0,2,5,7
Saving Christmas,,0,0,0,0
Good Kill,1 nomination.,0,0,1,1
Predestination,12 wins & 19 nominations,0,12,19,31
Gone Girl,Nominated for 1 Oscar. Another 64 wins & 187 nominations.,1,64,187,252
Pompeya,2 wins & 1 nomination.,0,2,1,3
Muppets Most Wanted,3 wins & 11 nominations.,0,3,11,14
Mr. Peabody & Sherman,2 wins & 16 nominations.,0,2,16,18
Fury,5 wins & 24 nominations.,0,5,24,29
Need for Speed,1 win & 5 nominations.,0,1,5,6
Neighbors,7 wins & 11 nominations.,0,7,11,18
Fuerza mayor,,0,0,0,0
Night at the Museum: Secret of the Tomb,1 win & 4 nominations.,0,1,4,5
Nightcrawler,Nominated for 1 Oscar. Another 42 wins & 123 nominations.,1,42,123,166
No Good Deed,2 wins & 2 nominations,0,2,2,4
Noah,1 win & 19 nominations.,0,1,19,20
Non-Stop,1 nomination.,0,0,1,1
Frank,13 wins & 18 nominations.,0,13,18,31
Foxcatcher,Nominated for 5 Oscars. 13 wins & 81 nominations total,5,13,81,99
Fortaleza prohibida,,0,0,0,0
Ouija,1 win.,0,1,0,1
Paddington,Nominated for 1 BAFTA Film Award. Another 3 wins & 6 nominations.,0,3,7,10
God's Not Dead,1 win.,0,1,0,1
God's Pocket,1 nomination,0,0,1,1
Moms' Night Out,1 win.,0,1,0,1
Pawn Sacrifice,1 win & 1 nomination,0,1,1,2
Mommy,54 wins & 66 nominations.,0,54,66,120
Penguins of Madagascar,8 nominations,0,0,8,8
Draft Day,1 nomination.,0,0,1,1
Dracula Untold,3 wins & 5 nominations,0,3,5,8
Selma,Won 1 Oscar. Another 57 wins & 91 nominations.,1,57,91,149
The Amazing Spider-Man 2,4 wins & 30 nominations.,0,4,30,34
The Bag Man,,0,0,0,0
The Best of Me,,0,0,0,0
The Book of Life,Nominated for 1 Golden Globe. Another 3 wins & 28 nominations.,0,3,29,32
The Boxtrolls,Nominated for 1 Oscar. Another 8 wins & 60 nominations.,1,8,60,69
Chef,2 wins & 4 nominations.,0,2,4,6
Life After Beth,6 nominations,0,0,6,6
Let's Be Cops,2 nominations.,0,0,2,2
The Disappearance of Eleanor Rigby: Them,3 wins & 9 nominations.,0,3,9,12
Left Behind,5 nominations.,0,0,5,5
The Drop,4 wins & 5 nominations.,0,4,5,9
The Equalizer,1 win & 9 nominations.,0,1,9,10
Captain America: The Winter Soldier,Nominated for 1 Oscar. Another 5 wins & 51 nominations.,1,5,51,57
The Expendables 3,2 wins & 5 nominations,0,2,5,7
Camp X-Ray,6 nominations,0,0,6,6
Calvary,9 wins & 32 nominations.,0,9,32,41
The Fault in Our Stars,21 wins & 17 nominations.,0,21,17,38
Cake,5 wins & 8 nominations,0,5,8,13
B�squeda implacable 3,,0,0,0,0
Las nubes de Mar�a,,0,0,0,0
The Gambler,1 win & 3 nominations,0,1,3,4
Cold in July,1 win & 8 nominations,0,1,8,9
Locos por las nueces,,0,0,0,0
Serena,1 win.,0,1,0,1
That Awkward Moment,1 win & 2 nominations.,0,1,2,3
Seventh Son,2 wins & 1 nomination,0,2,1,3
Sex Tape,2 wins & 3 nominations.,0,2,3,5
Divergent,7 wins & 11 nominations.,0,7,11,18
Mapa a las estrellas,,0,0,0,0
Sin City: A Dame to Kill For,4 wins & 6 nominations.,0,4,6,10
Deliver Us from Evil,2 wins & 4 nominations.,0,2,4,6
Maleficent,Nominated for 1 Oscar. Another 12 wins & 42 nominations.,1,12,42,55
Magic in the Moonlight,1 win & 1 nomination.,0,1,1,2
Song of the Sea,Nominated for 1 Oscar. Another 11 wins & 25 nominations.,1,11,25,37
Dear White People,13 wins & 28 nominations.,0,13,28,41
St. Vincent,6 wins & 23 nominations.,0,6,23,29
Dawn of the Planet of the Apes,Nominated for 1 Oscar. 17 wins & 48 nominations total,1,17,48,66
Step Up All In,,0,0,0,0
Lucy,1 win & 12 nominations.,0,1,12,13
Love & Mercy,2 wins & 1 nomination.,0,2,1,3
Tal vez es para siempre,,0,0,0,0
Lost River,3 wins & 5 nominations.,0,3,5,8
Tammy,1 win & 7 nominations,0,1,7,8
Testament of Youth,5 wins & 6 nominations.,0,5,6,11
Cooties,1 win & 4 nominations.,0,1,4,5
Heaven Is for Real,1 win & 5 nominations.,0,1,5,6
Heaven Knows What,5 wins & 12 nominations.,0,5,12,17
Kill the Messenger,3 wins & 6 nominations.,0,3,6,9
The Theory of Everything,Won 1 Oscar. Another 24 wins & 124 nominations.,1,24,124,149
300: Rise of an Empire,2 wins & 7 nominations.,0,2,7,9
About Last Night,1 nomination,0,0,1,1
H�ctor y el secreto de la felicidad,,0,0,0,0
A Walk Among the Tombstones,1 nomination.,0,0,1,1
It Follows,25 wins & 43 nominations.,0,25,43,68
Walk of Shame,,0,0,0,0
In Order of Disappearance,,0,0,0,0
A Most Wanted Man,3 wins & 6 nominations,0,3,6,9
A Most Violent Year,15 wins & 52 nominations.,0,15,52,67
A Million Ways to Die in the West,6 nominations.,0,0,6,6
A Long Way Down,,0,0,0,0
A Little Chaos,2 nominations,0,0,2,2
When the Game Stands Tall,1 nomination,0,0,1,1
The Signal,1 win & 3 nominations,0,1,3,4
A Haunted House 2,,0,0,0,0
While We're Young,1 win & 3 nominations.,0,1,3,4
Whiplash,Won 3 Oscars. Another 94 wins & 145 nominations.,3,94,145,242
Wild,Nominated for 2 Oscars. Another 13 wins & 67 nominations.,2,13,67,82
Into the Woods,Nominated for 3 Oscars. Another 10 wins & 71 nominations.,3,10,71,84
A Brilliant Young Mind,4 wins & 11 nominations.,0,4,11,15
Winter's Tale,2 nominations,0,0,2,2
Wish I Was Here,6 nominations.,0,0,6,6
99 Homes,Nominated for 1 Golden Globe. Another 12 wins & 23 nominations.,0,12,24,36
Barefoot,1 nomination,0,0,1,1
The Rover,3 wins & 19 nominations,0,3,19,22
X-Men: Days of Future Past,Nominated for 1 Oscar. 16 wins & 48 nominations total,1,16,48,65
5 to 7,1 win & 1 nomination.,0,1,1,2
Vampire Academy,2 nominations.,0,0,2,2
Jack Ryan: Shadow Recruit,3 nominations.,0,0,3,3
Addicted,,0,0,0,0
"I, Frankenstein",1 nomination,0,0,1,1
Annie,Nominated for 2 Oscars. Another 2 wins & 11 nominations.,2,2,11,15
I Origins,2 wins & 3 nominations,0,2,3,5
Think Like a Man Too,2 wins & 4 nominations,0,2,4,6
This Is Where I Leave You,1 nomination.,0,0,1,1
And So It Goes,1 nomination.,0,0,1,1
The Woman in Black 2: Angel of Death,2 wins & 2 nominations.,0,2,2,4
Top Five,5 wins & 21 nominations.,0,5,21,26
John Wick,5 wins & 10 nominations.,0,5,10,15
Transcendence,3 wins & 5 nominations,0,3,5,8
American Sniper,Won 1 Oscar. 24 wins & 43 nominations total,1,24,43,68
Transformers: Age of Extinction,5 wins & 23 nominations.,0,5,23,28
Trash,2 wins & 10 nominations total,0,2,10,12
Jersey Boys,4 wins & 2 nominations,0,4,2,6
Tusk,2 wins & 7 nominations,0,2,7,9
"As Above, So Below",1 win & 6 nominations.,0,1,6,7
"Two Days, One Night",,0,0,0,0
Two Night Stand,1 nomination,0,0,1,1
Just Before I Go,,0,0,0,0
The Two Faces of January,3 nominations,0,0,3,3
Una Se�al En La Tormenta,,0,0,0,0
Una buena mentira,,0,0,0,0
"Alexander and the Terrible, Horrible, No Good, Very Bad Day",1 win & 8 nominations.,0,1,8,9
Unbroken,Nominated for 3 Oscars. 15 wins & 33 nominations total,3,15,33,51
If I Stay,3 wins & 1 nomination.,0,3,1,4
Unfriended,3 wins & 6 nominations.,0,3,6,9
Into the Storm,2 wins & 1 nomination.,0,2,1,3
Annabelle,3 wins & 7 nominations.,0,3,7,10
Inherent Vice,Nominated for 2 Oscars. 15 wins & 98 nominations total,2,15,98,115
13 Sins,3 nominations,0,0,3,3
The Quiet Ones,7 nominations.,0,0,7,7
12 horas para sobrevivir,,0,0,0,0
How to Train Your Dragon 2,Nominated for 1 Oscar. 15 wins & 61 nominations total,1,15,61,77
Kill Me Three Times,4 nominations.,0,0,4,4
Interstellar,Won 1 Oscar. Another 43 wins & 148 nominations.,1,43,148,192
3 Days to Kill,,0,0,0,0
Zombeavers,,0,0,0,0
22 Jump Street,7 wins & 25 nominations,0,7,25,32
The Raid 2,5 wins & 10 nominations.,0,5,10,15
Tracks,2 wins & 18 nominations,0,2,18,20
Carrie,Nominated for 2 Oscars. Another 3 wins & 6 nominations.,2,3,6,11
The 100 Year-Old Man Who Climbed Out the Window and Disappeared,Nominated for 1 Oscar. Another 6 wins & 10 nominations.,1,6,10,17
Mandela: Long Walk to Freedom,Nominated for 1 Oscar. Another 14 wins & 34 nominations.,1,14,34,49
Austenland,1 nomination.,0,0,1,1
The Double,1 win & 11 nominations.,0,1,11,12
Labor Day,6 nominations,0,0,6,6
Scary Movie 5,5 nominations,0,0,5,5
The Heat,7 wins & 16 nominations,0,7,16,23
V/H/S/2,1 win & 7 nominations.,0,1,7,8
Se levanta el viento,,0,0,0,0
August: Osage County,Nominated for 2 Oscars. Another 16 wins & 63 nominations.,2,16,63,81
Amores infieles,,0,0,0,0
Jack the Giant Slayer,1 win & 4 nominations,0,1,4,5
Texas Chainsaw 3D,,0,0,0,0
The Hangover Part III,2 wins & 7 nominations.,0,2,7,9
Adult World,1 nomination.,0,0,1,1
About Time,3 wins & 9 nominations.,0,3,9,12
Lee Daniels' The Butler,,0,0,0,0
The To Do List,,0,0,0,0
Don Jon,2 wins & 27 nominations,0,2,27,29
Adore,,0,0,0,0
Breathe In,3 nominations.,0,0,3,3
Dom Hemingway,2 nominations.,0,0,2,2
Saving Mr. Banks,Nominated for 1 Oscar. 13 wins & 74 nominations total,1,13,74,88
Trance,3 wins & 3 nominations.,0,3,3,6
Belle,13 wins & 32 nominations.,0,13,32,45
Iron Man 3,Nominated for 1 Oscar. Another 20 wins & 62 nominations.,1,20,62,83
Movie 43,4 wins & 5 nominations,0,4,5,9
Joe,4 wins & 9 nominations,0,4,9,13
Grudge Match,1 win & 1 nomination.,0,1,1,2
2 Guns,3 wins,0,3,0,3
Romeo & Juliet,,0,0,0,0
The Tale of the Princess Kaguya,,0,0,0,0
The Hunger Games: Catching Fire,22 wins & 68 nominations.,0,22,68,90
Runner Runner,2 nominations.,0,0,2,2
Locke,7 wins & 33 nominations.,0,7,33,40
Gangster Squad,5 nominations.,0,0,5,5
Safe Haven,3 wins & 7 nominations.,0,3,7,10
Drinking Buddies,1 win & 4 nominations.,0,1,4,5
Killing Season,,0,0,0,0
La noche de la expiaci�n,,0,0,0,0
The Wolverine,2 wins & 11 nominations,0,2,11,13
Homefront,1 nomination.,0,0,1,1
The Hobbit: The Desolation of Smaug,Nominated for 3 Oscars. 19 wins & 90 nominations total,3,19,90,112
The Wolf of Wall Street,Nominated for 5 Oscars. Another 37 wins & 174 nominations.,5,37,174,216
Short Term 12,37 wins & 71 nominations,0,37,71,108
Broken City,1 win.,0,1,0,1
Side Effects,5 nominations.,0,0,5,5
Ida,Won 1 Oscar. 68 wins & 92 nominations total,1,68,92,161
I'm So Excited!,1 nomination.,0,0,1,1
Un pasado imborrable,,0,0,0,0
Dead Man Down,,0,0,0,0
Star Trek Into Darkness,Nominated for 1 Oscar. Another 7 wins & 58 nominations.,1,7,58,66
American Hustle,Nominated for 10 Oscars. Another 69 wins & 217 nominations.,10,69,217,296
Dark Skies,,0,0,0,0
CBGB,,0,0,0,0
Nebraska,Nominated for 6 Oscars. Another 29 wins & 162 nominations.,6,29,162,197
Last Vegas,4 wins & 1 nomination,0,4,1,5
Insidious: Chapter 2,16 nominations.,0,0,16,16
Stoker,4 wins & 45 nominations.,0,4,45,49
Before Midnight,Nominated for 1 Oscar. 20 wins & 63 nominations total,1,20,63,84
S�lo los amantes sobreviven,,0,0,0,0
S�lo Dios perdona,,0,0,0,0
All Is Lost,Nominated for 1 Oscar. 3 wins & 48 nominations total,1,3,48,52
The Fifth Estate,2 wins & 3 nominations.,0,2,3,5
Machete Kills,3 nominations,0,0,3,3
Dallas Buyers Club,Won 3 Oscars. 84 wins & 86 nominations total,3,84,86,173
Turbo,1 win & 13 nominations total,0,1,13,14
Lovelace,1 win & 3 nominations.,0,1,3,4
Jimi: All Is by My Side,1 win & 10 nominations.,0,1,10,11
The Family,1 nomination.,0,0,1,1
The Way Way Back,5 wins & 30 nominations,0,5,30,35
The Green Inferno,1 win & 6 nominations.,0,1,6,7
Identity Thief,1 win & 9 nominations.,0,1,9,10
After Earth,3 wins & 8 nominations.,0,3,8,11
Instructions Not Included,1 nomination.,0,0,1,1
G.I. Joe: Retaliation,1 win & 12 nominations.,0,1,12,13
12 Years a Slave,Won 3 Oscars. Another 240 wins & 336 nominations.,3,240,336,579
Diana,2 wins & 2 nominations,0,2,2,4
Man of Tai Chi,,0,0,0,0
The East,1 win & 7 nominations,0,1,7,8
Afternoon Delight,1 win & 3 nominations.,0,1,3,4
The Grandmaster,,0,0,0,0
Temptation: Confessions of a Marriage Counselor,1 win & 5 nominations.,0,1,5,6
Hansel y Gretel: Cazadores de brujas,,0,0,0,0
Man of Steel,7 wins & 46 nominations.,0,7,46,53
Despicable Me 2,Nominated for 2 Oscars. Another 12 wins & 64 nominations.,2,12,64,78
Lone Survivor,Nominated for 2 Oscars. Another 6 wins & 14 nominations.,2,6,14,22
Mam�,3 wins.,0,3,0,3
Ain't Them Bodies Saints,4 wins & 14 nominations.,0,4,14,18
I Give It a Year,1 win & 1 nomination.,0,1,1,2
Delivery Man,,0,0,0,0
Under the Skin,Nominated for 1 BAFTA Film Award. Another 23 wins & 110 nominations.,0,23,111,134
Snitch,1 nomination,0,0,1,1
How I Live Now,1 win & 8 nominations.,0,1,8,9
Fruitvale Station,36 wins & 57 nominations.,0,36,57,93
Begin Again,Nominated for 1 Oscar. Another 5 wins & 17 nominations.,1,5,17,23
Captain Phillips,Nominated for 6 Oscars. 16 wins & 154 nominations total,6,16,154,176
Riddick,2 nominations.,0,0,2,2
Grown Ups 2,5 wins & 15 nominations.,0,5,15,20
Walking with the Enemy,1 win.,0,1,0,1
Gimme Shelter,3 wins & 1 nomination.,0,3,1,4
Fast & Furious 6,10 wins & 22 nominations.,0,10,22,32
Her,Won 1 Oscar. Another 82 wins & 186 nominations.,1,82,186,269
The Canyons,5 wins & 2 nominations.,0,5,2,7
The Secret Life of Walter Mitty,5 wins & 18 nominations,0,5,18,23
The Lone Ranger,Nominated for 2 Oscars. 5 wins & 20 nominations total,2,5,20,27
The Call,1 win & 11 nominations,0,1,11,12
Planes,5 nominations.,0,0,5,5
White House Down,3 wins & 9 nominations.,0,3,9,12
A Good Day to Die Hard,5 wins & 8 nominations.,0,5,8,13
Fading Gigolo,2 wins & 1 nomination,0,2,1,3
Charlie Countryman,2 nominations.,0,0,2,2
A Haunted House,1 win & 1 nomination.,0,1,1,2
Inside Llewyn Davis,Nominated for 2 Oscars. Another 46 wins & 172 nominations.,2,46,172,220
Evil Dead,6 wins & 19 nominations,0,6,19,25
The Last Days on Mars,4 nominations.,0,0,4,4
Bad Grandpa,Nominated for 1 Oscar. 1 win & 10 nominations total,1,1,10,12
The Book Thief,Nominated for 1 Oscar. Another 9 wins & 16 nominations.,1,9,16,26
Prisoners,Nominated for 1 Oscar. Another 10 wins & 37 nominations.,1,10,37,48
The Immigrant,17 wins & 29 nominations.,0,17,29,46
The Bling Ring,4 wins & 7 nominations.,0,4,7,11
I Spit on Your Grave 2,,0,0,0,0
Kill Your Darlings,5 wins & 13 nominations.,0,5,13,18
The Big Wedding,2 nominations.,0,0,2,2
This Is the End,10 wins & 22 nominations.,0,10,22,32
The Smurfs 2,8 nominations,0,0,8,8
Europa Report,1 win & 2 nominations,0,1,2,3
The Best Offer,,0,0,0,0
What If,,0,0,0,0
Philomena,Nominated for 4 Oscars. Another 33 wins & 81 nominations.,4,33,81,118
Percy Jackson: Sea of Monsters,3 wins & 5 nominations,0,3,5,8
The Croods,Nominated for 1 Oscar. 5 wins & 46 nominations total,1,5,46,52
The Mortal Instruments: City of Bones,6 wins & 11 nominations.,0,6,11,17
Out of the Furnace,1 win & 10 nominations,0,1,10,11
The Zero Theorem,2 wins & 7 nominations.,0,2,7,9
Monsters University,Nominated for 1 BAFTA Film Award. Another 9 wins & 57 nominations.,0,9,58,67
Oz the Great and Powerful,6 wins & 31 nominations.,0,6,31,37
Pacific Rim,Nominated for 1 BAFTA Film Award. Another 7 wins & 47 nominations.,0,7,48,55
42,2 wins & 21 nominations.,0,2,21,23
Pain & Gain,4 nominations.,0,0,4,4
Palo Alto,4 nominations,0,0,4,4
47 Ronin,5 nominations.,0,0,5,5
Olympus Has Fallen,1 win & 5 nominations.,0,1,5,6
The Conjuring,15 wins & 22 nominations.,0,15,22,37
Paranoia,1 nomination.,0,0,1,1
Oculus,3 wins & 17 nominations,0,3,17,20
Life of Crime,,0,0,0,0
Parker,1 nomination.,0,0,1,1
Filth,9 wins & 14 nominations.,0,9,14,23
Parkland,3 nominations.,0,0,3,3
The Sacrament,4 wins & 12 nominations.,0,4,12,16
World War Z,3 wins & 25 nominations.,0,3,25,28
Knights of Badassdom,2 nominations.,0,0,2,2
Pawn,,0,0,0,0
Oblivion,1 win & 17 nominations.,0,1,17,18
The Lunchbox,Nominated for 1 BAFTA Film Award. Another 28 wins & 37 nominations.,0,28,38,66
Now You See Me,1 win & 3 nominations,0,1,3,4
Kick-Ass 2,1 win & 9 nominations,0,1,9,10
Anna,1 nomination.,0,0,1,1
Welcome to the Punch,2 wins.,0,2,0,2
The Last Stand,1 win & 2 nominations.,0,1,2,3
Escape Plan,2 nominations,0,0,2,2
Ender's Game,1 win & 6 nominations.,0,1,6,7
Gravity,Won 7 Oscars. Another 230 wins & 187 nominations.,7,230,187,424
Cloudy with a Chance of Meatballs 2,16 nominations.,0,0,16,16
Thor: The Dark World,4 wins & 21 nominations.,0,4,21,25
Anchorman 2: The Legend Continues,1 win & 23 nominations.,0,1,23,24
Journey to the West,2 wins & 21 nominations.,0,2,21,23
The Invisible Woman,Nominated for 1 Oscar. Another 1 win & 6 nominations.,1,1,6,8
Elysium,1 win & 10 nominations.,0,1,10,11
Blue Is the Warmest Color,,0,0,0,0
Blue Jasmine,Won 1 Oscar. Another 55 wins & 81 nominations.,1,55,81,137
Blue Ruin,7 wins & 20 nominations.,0,7,20,27
Redemption,,0,0,0,0
21 & Over,1 win & 5 nominations,0,1,5,6
The Internship,2 nominations.,0,0,2,2
Warm Bodies,2 wins & 10 nominations.,0,2,10,12
El pasado,1 win & 4 nominations.,0,1,4,5
El gran Gatsby,,0,0,0,0
El expreso del miedo,,0,0,0,0
In Secret,1 nomination.,0,0,1,1
The Incredible Burt Wonderstone,1 win & 4 nominations,0,1,4,5
The Art of the Steal,5 nominations.,0,0,5,5
The World's End,4 wins & 27 nominations,0,4,27,31
We Are What We Are,5 wins & 11 nominations,0,5,11,16
Jobs,2 nominations.,0,0,2,2
R.I.P.D.,,0,0,0,0
We're the Millers,4 wins & 17 nominations.,0,4,17,21
Epic,2 wins & 21 nominations.,0,2,21,23
The Kings of Summer,5 wins & 10 nominations.,0,5,10,15
Horns,4 wins & 4 nominations,0,4,4,8
In a World...,3 wins & 17 nominations.,0,3,17,20
The Spectacular Now,9 wins & 32 nominations.,0,9,32,41
Blood Ties,,0,0,0,0
RED 2,3 nominations.,0,0,3,3
Enough Said,Nominated for 1 Golden Globe. Another 8 wins & 37 nominations.,0,8,38,46
The Best Man Holiday,3 wins & 15 nominations.,0,3,15,18
Enemigos id�nticos,,0,0,0,0
To the Wonder,5 wins & 10 nominations,0,5,10,15
John Carter,2 wins & 8 nominations.,0,2,8,10
The Cold Light of Day,2 nominations.,0,0,2,2
The Collection,,0,0,0,0
Journey 2: The Mysterious Island,7 wins & 4 nominations.,0,7,4,11
The Apparition,1 nomination.,0,0,1,1
The Amazing Spider-Man,2 wins & 31 nominations.,0,2,31,33
Tim and Eric's Billion Dollar Movie,1 nomination.,0,0,1,1
Trouble with the Curve,2 wins & 1 nomination.,0,2,1,3
The Company You Keep,2 wins & 1 nomination.,0,2,1,3
This Is 40,2 wins & 11 nominations.,0,2,11,13
To Rome with Love,2 wins & 5 nominations.,0,2,5,7
This Means War,1 win & 6 nominations,0,1,6,7
Contraband,1 win.,0,1,0,1
Furia de Titanes 2,,0,0,0,0
John Dies at the End,2 wins & 6 nominations.,0,2,6,8
Compliance,7 wins & 35 nominations.,0,7,35,42
Life of Pi,Won 4 Oscars. 81 wins & 134 nominations total,4,81,134,219
Cloud Atlas,15 wins & 79 nominations.,0,15,79,94
Mud,15 wins & 39 nominations.,0,15,39,54
The Cabin in the Woods,20 wins & 34 nominations.,0,20,34,54
Chronicle,2 wins & 7 nominations.,0,2,7,9
Lincoln,Won 2 Oscars. 108 wins & 252 nominations total,2,108,252,362
Amour,Won 1 Oscar. Another 82 wins & 107 nominations.,1,82,107,190
Cosm�polis,,0,0,0,0
The Bay,1 win & 1 nomination.,0,1,1,2
The Campaign,2 wins & 4 nominations.,0,2,4,6
[REC] 3: Genesis,,0,0,0,0
Looper,18 wins & 47 nominations.,0,18,47,65
The Bourne Legacy,1 win & 11 nominations,0,1,11,12
Total Recall,Won 1 Oscar. 7 wins & 16 nominations total,1,7,16,24
Thanks for Sharing,2 nominations.,0,0,2,2
Lockout,1 nomination,0,0,1,1
American Reunion,1 win & 4 nominations,0,1,4,5
Terror en Silent Hill 2: la revelaci�n,,0,0,0,0
That's My Boy,5 wins & 10 nominations.,0,5,10,15
Ted,Nominated for 1 Oscar. Another 13 wins & 27 nominations.,1,13,27,41
Think Like a Man,3 wins & 14 nominations,0,3,14,17
Todo lo que necesitas es amor,,0,0,0,0
One for the Money,1 win & 1 nomination.,0,1,1,2
Stuck in Love,3 wins.,0,3,0,3
En la casa,,0,0,0,0
What Maisie Knew,3 wins & 8 nominations,0,3,8,11
Prometheus,Nominated for 1 Oscar. Another 6 wins & 46 nominations.,1,6,46,53
Protegiendo al enemigo,,0,0,0,0
Quartet,Nominated for 1 Golden Globe. Another 4 wins & 4 nominations.,0,4,5,9
End of Watch,3 wins & 10 nominations,0,3,10,13
Red Dawn,1 win & 4 nominations.,0,1,4,5
21 Jump Street,11 wins & 21 nominations,0,11,21,32
Red Lights,2 nominations.,0,0,2,2
Red Tails,2 wins & 9 nominations.,0,2,9,11
No One Lives,1 nomination.,0,0,1,1
Renoir,3 wins & 11 nominations.,0,3,11,14
Men in Black 3,1 win & 13 nominations.,0,1,13,14
A Royal Affair,Nominated for 1 Oscar. Another 21 wins & 37 nominations.,1,21,37,59
Resident Evil: Retribution,2 wins & 6 nominations.,0,2,6,8
Wanderlust,1 win.,0,1,0,1
Rise of the Guardians,14 wins & 32 nominations.,0,14,32,46
A Late Quartet,1 win & 2 nominations,0,1,2,3
Mirror Mirror,Nominated for 1 Oscar. Another 2 wins & 8 nominations.,1,2,8,11
What to Expect When You're Expecting,12 nominations.,0,0,12,12
Flight,Nominated for 2 Oscars. Another 15 wins & 43 nominations.,2,15,43,60
On the Road,2 wins & 4 nominations,0,2,4,6
ParaNorman,Nominated for 1 Oscar. 19 wins & 46 nominations total,1,19,46,66
Paranormal Activity 4,2 wins,0,2,0,2
"For a Good Time, Call...",,0,0,0,0
Parental Guidance,1 win & 4 nominations.,0,1,4,5
"Pasi�n, un asesinato perfecto",,0,0,0,0
Wreck-It Ralph,Nominated for 1 Oscar. Another 33 wins & 41 nominations.,1,33,41,75
Into the White,3 nominations,0,0,3,3
Girl Most Likely,,0,0,0,0
Not Fade Away,3 wins & 3 nominations.,0,3,3,6
People Like Us,,0,0,0,0
Piranha 3DD,2 wins & 5 nominations.,0,2,5,7
"Farewell, My Queen",6 wins & 12 nominations.,0,6,12,18
Frances Ha,1 win & 49 nominations.,0,1,49,50
Pitch Perfect,7 wins & 20 nominations,0,7,20,27
Gone,,0,0,0,0
Frankenweenie,Nominated for 1 Oscar. Another 11 wins & 49 nominations.,1,11,49,61
Premium Rush,1 win & 4 nominations.,0,1,4,5
Ginger & Rosa,,0,0,0,0
A Hijacking,16 wins & 26 nominations.,0,16,26,42
Robot & Frank,2 wins & 6 nominations.,0,2,6,8
Rock of Ages,2 wins & 8 nominations.,0,2,8,10
A Thousand Words,3 nominations.,0,0,3,3
Silver Linings Playbook,Won 1 Oscar. Another 88 wins & 148 nominations.,1,88,148,237
Universal Soldier: Day of Reckoning,,0,0,0,0
Sinister,3 wins & 14 nominations,0,3,14,17
Aftershock,3 nominations.,0,0,3,3
Skyfall,Won 2 Oscars. Another 65 wins & 123 nominations.,2,65,123,190
Underworld Awakening,1 win,0,1,0,1
Smashed,10 nominations.,0,0,10,10
If I Were You,4 wins & 13 nominations.,0,4,13,17
Snow White and the Huntsman,Nominated for 2 Oscars. 13 wins & 33 nominations total,2,13,33,48
Magic Mike,9 wins & 14 nominations,0,9,14,23
Madea's Witness Protection,1 win & 5 nominations,0,1,5,6
Alex Cross,4 nominations,0,0,4,4
Spring Breakers,10 wins & 36 nominations,0,10,36,46
Madagascar 3: Europe's Most Wanted,3 wins & 20 nominations,0,3,20,23
Stand Up Guys,,0,0,0,0
Ice Age: Continental Drift,2 wins & 11 nominations.,0,2,11,13
Fun Size,,0,0,0,0
Dark Shadows,2 wins & 13 nominations.,0,2,13,15
Step Up Revolution,1 nomination,0,0,1,1
Stolen,,0,0,0,0
Twice Born,7 nominations.,0,0,7,7
Diary of a Wimpy Kid: Dog Days,2 wins & 7 nominations,0,2,7,9
Man on a Ledge,1 nomination.,0,0,1,1
Ruby Sparks,1 win & 11 nominations,0,1,11,12
Disconnect,,0,0,0,0
ATM,,0,0,0,0
Jack Reacher,1 win & 6 nominations.,0,1,6,7
Vamps,,0,0,0,0
Rust and Bone,,0,0,0,0
Dredd,2 wins & 14 nominations.,0,2,14,16
Safety Not Guaranteed,8 wins & 18 nominations.,0,8,18,26
No,Nominated for 1 Oscar. Another 13 wins & 20 nominations.,1,13,20,34
About Cherry,,0,0,0,0
Zero Dark Thirty,Won 1 Oscar. Another 84 wins & 173 nominations.,1,84,173,258
Savages,7 nominations,0,0,7,7
Save the Date,3 wins & 2 nominations,0,3,2,5
Abraham Lincoln: Vampire Hunter,1 nomination,0,0,1,1
V/H/S,5 nominations,0,0,5,5
Seeking a Friend for the End of the World,3 nominations,0,0,3,3
Act of Valor,1 win & 7 nominations.,0,1,7,8
Upside Down,6 nominations.,0,0,6,6
Seven Psychopaths,3 wins & 21 nominations.,0,3,21,24
Moonrise Kingdom,Nominated for 1 Oscar. Another 36 wins & 121 nominations.,1,36,121,158
Shadow Dancer,8 wins & 9 nominations.,0,8,9,17
Django Unchained,Won 2 Oscars. Another 55 wins & 158 nominations.,2,55,158,215
Chernobyl Diaries,1 nomination,0,0,1,1
Arbitrage,4 wins & 5 nominations.,0,4,5,9
The Five-Year Engagement,,0,0,0,0
Kon-Tiki,Nominated for 1 Oscar. Another 12 wins & 13 nominations.,1,12,13,26
The First Time,1 nomination,0,0,1,1
The Vow,3 wins & 14 nominations.,0,3,14,17
Lawless,1 win & 8 nominations,0,1,8,9
Lay the Favorite,1 nomination.,0,0,1,1
The Reluctant Fundamentalist,3 wins,0,3,0,3
The Watch,2 nominations,0,0,2,2
House at the End of the Street,1 win & 3 nominations,0,1,3,4
The Expendables 2,4 wins & 5 nominations.,0,4,5,9
Argo,Won 3 Oscars. Another 91 wins & 155 nominations.,3,91,155,249
The Odd Life of Timothy Green,1 win & 8 nominations.,0,1,8,9
Battleship,4 wins & 16 nominations,0,4,16,20
Bel Ami,,0,0,0,0
Joyful Noise,1 nomination,0,0,1,1
The Raven,5 nominations,0,0,5,5
Being Flynn,1 win.,0,1,0,1
Casa de mi Padre,3 wins & 8 nominations.,0,3,8,11
The Woman in Black,5 wins & 14 nominations.,0,5,14,19
The Dictator,1 win & 1 nomination.,0,1,1,2
The Devil Inside,2 wins & 3 nominations.,0,2,3,5
The Paperboy,5 wins & 12 nominations.,0,5,12,17
Celeste & Jesse Forever,7 wins & 12 nominations.,0,7,12,19
Beasts of the Southern Wild,Nominated for 4 Oscars. Another 90 wins & 130 nominations.,4,90,130,224
The Words,1 win & 3 nominations.,0,1,3,4
The Perks of Being a Wallflower,19 wins & 50 nominations.,0,19,50,69
B�squeda implacable 2,,0,0,0,0
Byzantium,2 wins & 7 nominations.,0,2,7,9
Hit and Run,1 win,0,1,0,1
The Master,Nominated for 3 Oscars. Another 75 wins & 184 nominations.,3,75,184,262
Hope Springs,Nominated for 1 Golden Globe. Another 2 wins & 4 nominations.,0,2,5,7
Bachelorette,1 win & 2 nominations,0,1,2,3
Hyde Park on Hudson,Nominated for 1 Golden Globe. Another 1 win & 4 nominations.,0,1,5,6
The Impossible,Nominated for 1 Oscar. Another 28 wins & 68 nominations.,1,28,68,97
The Sweeney,5 nominations,0,0,5,5
The Iceman,2 wins,0,2,0,2
LOL,1 nomination,0,0,1,1
The Hunt,Nominated for 1 Oscar. Another 37 wins & 69 nominations.,1,37,69,107
The Hunger Games,Nominated for 1 Golden Globe. Another 33 wins & 47 nominations.,0,33,48,81
The Hobbit: An Unexpected Journey,Nominated for 3 Oscars. Another 11 wins & 72 nominations.,3,11,72,86
The Three Stooges,4 nominations,0,0,4,4
Brave,Won 1 Oscar. 20 wins & 48 nominations total,1,20,48,69
The Sessions,Nominated for 1 Oscar. Another 18 wins & 63 nominations.,1,18,63,82
The Guilt Trip,1 nomination.,0,0,1,1
The Lorax,4 wins & 8 nominations.,0,4,8,12
The Lords of Salem,1 win & 3 nominations.,0,1,3,4
At Any Price,1 nomination,0,0,1,1
Hitchcock,Nominated for 1 Oscar. 5 wins & 29 nominations total,1,5,29,35
The Lucky One,5 wins & 7 nominations.,0,5,7,12
Bullet to the Head,1 nomination,0,0,1,1
The Samaritan,4 nominations.,0,0,4,4
The Magic of Belle Isle,1 nomination,0,0,1,1
Hotel Transylvania,2 wins & 15 nominations.,0,2,15,17
The Twilight Saga: Breaking Dawn - Part 2,21 wins & 15 nominations.,0,21,15,36
Big Miracle,1 nomination.,0,0,1,1
The Man with the Iron Fists,4 nominations,0,0,4,4
The Pirates! Band of Misfits,,0,0,0,0
La bicicleta verde,,0,0,0,0
Here Comes the Boom,3 nominations.,0,0,3,3
Killing Them Softly,3 wins & 9 nominations,0,3,9,12
The Place Beyond the Pines,5 wins & 22 nominations.,0,5,22,27
The Dark Knight Rises,38 wins & 103 nominations total,0,38,103,141
The Possession,6 nominations.,0,0,6,6
Liberal Arts,7 nominations,0,0,7,7
Chasing Mavericks,,0,0,0,0
Atlas Shrugged: Part I,1 win.,0,1,0,1
One Day,1 win & 2 nominations.,0,1,2,3
Paul,2 wins & 9 nominations.,0,2,9,11
A Little Bit of Heaven,,0,0,0,0
Abduction,2 wins & 3 nominations.,0,2,3,5
Prom,1 nomination.,0,0,1,1
Footloose,Nominated for 2 Oscars. 1 win & 6 nominations total,2,1,6,9
The Best Exotic Marigold Hotel,4 wins & 22 nominations total,0,4,22,26
The Grey,2 wins & 8 nominations.,0,2,8,10
The Muppets,Won 1 Oscar. Another 16 wins & 43 nominations.,1,16,43,60
Sucker Punch,1 win & 11 nominations,0,1,11,12
The Sitter,2 nominations.,0,0,2,2
Drive Angry,1 win & 6 nominations.,0,1,6,7
Drive,Nominated for 1 Oscar. Another 79 wins & 179 nominations.,1,79,179,259
Limitless,2 wins & 8 nominations.,0,2,8,10
Margin Call,Nominated for 1 Oscar. 8 wins & 24 nominations total,1,8,24,33
"Big Mommas: Like Father, Like Son",4 nominations.,0,0,4,4
The Thing,3 nominations.,0,0,3,3
Straw Dogs,Nominated for 1 Oscar. Another 1 win & 1 nomination.,1,1,1,3
The Lincoln Lawyer,1 nomination.,0,0,1,1
Arthur,3 wins & 6 nominations.,0,3,6,9
Hysteria,2 nominations,0,0,2,2
Super 8,11 wins & 70 nominations.,0,11,70,81
Aislados,5 wins & 4 nominations.,0,5,4,9
30 minutos o menos,,0,0,0,0
10 Years,,0,0,0,0
The Hunter,4 wins & 23 nominations.,0,4,23,27
Take This Waltz,3 wins & 19 nominations.,0,3,19,22
"Peace, Love, & Misunderstanding",1 win.,0,1,0,1
Take Shelter,42 wins & 46 nominations.,0,42,46,88
Take Me Home Tonight,1 nomination.,0,0,1,1
Take Me Home,4 wins.,0,4,0,4
Violet & Daisy,4 wins & 12 nominations.,0,4,12,16
Puncture,2 wins.,0,2,0,2
A Very Harold & Kumar 3D Christmas,1 nomination,0,0,1,1
Battle Los Angeles,1 win & 4 nominations.,0,1,4,5
Shame,50 wins & 94 nominations total,0,50,94,144
Goon,1 win & 13 nominations.,0,1,13,14
Another Earth,7 wins & 13 nominations,0,7,13,20
Happy Feet Two,3 wins & 9 nominations,0,3,9,12
The Smurfs,2 wins & 8 nominations,0,2,8,10
Kung Fu Panda 2,Nominated for 1 Oscar. 5 wins & 47 nominations total,1,5,47,53
You're Next,11 wins & 20 nominations.,0,11,20,31
J. Edgar,5 wins & 17 nominations,0,5,17,22
Alvin and the Chipmunks: Chipwrecked,2 wins & 1 nomination.,0,2,1,3
The Rite,1 win & 5 nominations,0,1,5,6
A Good Old Fashioned Orgy,,0,0,0,0
Salmon Fishing in the Yemen,6 nominations.,0,0,6,6
I Am Number Four,1 win & 1 nomination,0,1,1,2
Martha Marcy May Marlene,22 wins & 74 nominations.,0,22,74,96
The Rum Diary,2 wins & 4 nominations.,0,2,4,6
Moneyball,Nominated for 6 Oscars. Another 29 wins & 76 nominations.,6,29,76,111
Scream 4,1 win & 6 nominations.,0,1,6,7
Season of the Witch,2 nominations.,0,0,2,2
Attack the Block,19 wins & 39 nominations total,0,19,39,58
God Bless America,5 nominations,0,0,5,5
Spy Kids 4: All the Time in the World,6 nominations,0,0,6,6
Butter,,0,0,0,0
In the Land of Blood and Honey,6 wins & 7 nominations,0,6,7,13
Extremely Loud & Incredibly Close,Nominated for 2 Oscars. Another 8 wins & 23 nominations.,2,8,23,33
Hall Pass,,0,0,0,0
Shark Night 3D,,0,0,0,0
Seeking Justice,1 nomination.,0,0,1,1
50/50,Nominated for 2 Golden Globes. Another 12 wins & 26 nominations.,0,12,28,40
Jack and Jill,14 wins & 5 nominations,0,14,5,19
Paranormal Activity 3,1 win & 6 nominations.,0,1,6,7
The Roommate,7 nominations,0,0,7,7
Killer Joe,9 wins & 21 nominations,0,9,21,30
X-Men: First Class,21 wins & 39 nominations.,0,21,39,60
The Hangover Part II,5 wins & 18 nominations.,0,5,18,23
Soul Surfer,2 wins & 12 nominations.,0,2,12,14
Sound of My Voice,1 win & 8 nominations,0,1,8,9
Like Crazy,9 wins & 7 nominations,0,9,7,16
The Mechanic,1 nomination.,0,0,1,1
The Ledge,1 nomination.,0,0,1,1
Bad Teacher,6 wins & 4 nominations.,0,6,4,10
The Help,Won 1 Oscar. Another 78 wins & 121 nominations.,1,78,121,200
Something Borrowed,5 nominations,0,0,5,5
Sanctum,1 win & 1 nomination.,0,1,1,2
Princesa por accidente,,0,0,0,0
Dream House,2 nominations,0,0,2,2
Our Idiot Brother,,0,0,0,0
360,3 nominations.,0,0,3,3
My Week with Marilyn,Nominated for 2 Oscars. Another 18 wins & 62 nominations.,2,18,62,82
La piel que habito,28 wins & 69 nominations total,0,28,69,97
The Flowers of War,Nominated for 1 Golden Globe. Another 15 wins & 15 nominations.,0,15,16,31
Bullhead,1 win.,0,1,0,1
Anonymous,Nominated for 1 Oscar. 7 wins & 12 nominations total,1,7,12,20
Dolphin Tale,4 wins & 4 nominations.,0,4,4,8
Bridesmaids,Nominated for 2 Oscars. Another 25 wins & 70 nominations.,2,25,70,97
Machine Gun Preacher,2 nominations,0,0,2,2
Albert Nobbs,Nominated for 3 Oscars. Another 19 wins & 39 nominations.,3,19,39,61
Harry Potter and the Deathly Hallows: Part 2,Nominated for 3 Oscars. Another 46 wins & 91 nominations.,3,46,91,140
Gnomeo & Juliet,1 win & 12 nominations.,0,1,12,13
What's Your Number?,1 win,0,1,0,1
Immortals,1 win & 6 nominations.,0,1,6,7
Ghost Rider: Spirit of Vengeance,4 nominations.,0,0,4,4
Kill the Irishman,1 nomination,0,0,1,1
Final Destination 5,2 wins & 6 nominations,0,2,6,8
Margaret,9 wins & 18 nominations.,0,9,18,27
Puss in Boots,Nominated for 1 Oscar. 9 wins & 43 nominations total,1,9,43,53
The Artist,Won 5 Oscars. 162 wins & 204 nominations total,5,162,204,371
The Innkeepers,2 wins & 5 nominations.,0,2,5,7
From Up on Poppy Hill,,0,0,0,0
A Dangerous Method,18 wins & 28 nominations,0,18,28,46
Colombiana,2 wins & 5 nominations.,0,2,5,7
The Art of Getting By,1 win & 2 nominations.,0,1,2,3
New Year's Eve,2 wins & 8 nominations.,0,2,8,10
The Raid: Redemption,8 wins & 13 nominations.,0,8,13,21
Melancol�a,,0,0,0,0
The Devil's Double,4 nominations.,0,0,4,4
War Horse,Nominated for 6 Oscars. Another 15 wins & 71 nominations.,6,15,71,92
Fright Night,2 wins & 8 nominations.,0,2,8,10
Catch .44,,0,0,0,0
In Time,2 nominations.,0,0,2,2
Conan the Barbarian,2 wins & 9 nominations.,0,2,9,11
The Guard,17 wins & 28 nominations total,0,17,28,45
The Dilemma,1 nomination.,0,0,1,1
Friends with Kids,2 nominations.,0,0,2,2
The Adjustment Bureau,1 win & 9 nominations.,0,1,9,10
Friends with Benefits,1 win & 5 nominations.,0,1,5,6
Larry Crowne,3 nominations.,0,0,3,3
We Bought a Zoo,1 win & 8 nominations.,0,1,8,9
Johnny English Reborn,4 nominations,0,0,4,4
Pirates of the Caribbean: On Stranger Tides,3 wins & 31 nominations.,0,3,31,34
The Descendants,Won 1 Oscar. Another 64 wins & 147 nominations.,1,64,147,212
Tower Heist,3 nominations.,0,0,3,3
Cedar Rapids,1 win & 4 nominations.,0,1,4,5
This Must Be the Place,19 wins & 17 nominations.,0,19,17,36
Thor,5 wins & 30 nominations.,0,5,30,35
The Beaver,2 wins & 12 nominations.,0,2,12,14
The Darkest Hour,1 nomination.,0,0,1,1
The Green Hornet,4 wins & 7 nominations.,0,4,7,11
Water for Elephants,3 wins & 13 nominations,0,3,13,16
Zookeeper,1 win & 2 nominations,0,1,2,3
The Intouchables,Nominated for 1 BAFTA Film Award. Another 38 wins & 39 nominations.,0,38,40,78
Chalet Girl,1 nomination.,0,0,1,1
Mission: Impossible - Ghost Protocol,5 wins & 30 nominations.,0,5,30,35
Silent House,1 win & 2 nominations.,0,1,2,3
Hanna,8 wins & 26 nominations.,0,8,26,34
Green Lantern,3 wins & 6 nominations.,0,3,6,9
Diary of a Wimpy Kid: Rodrick Rules,2 wins & 5 nominations,0,2,5,7
The Decoy Bride,1 win & 1 nomination.,0,1,1,2
The Deep Blue Sea,4 wins & 13 nominations,0,4,13,17
Warrior,Nominated for 1 Oscar. Another 5 wins & 21 nominations.,1,5,21,27
The Big Year,1 win.,0,1,0,1
Just Go with It,5 wins & 13 nominations.,0,5,13,18
Fast Five,9 wins & 21 nominations.,0,9,21,30
Red State,3 wins & 8 nominations,0,3,8,11
Red Riding Hood,5 nominations.,0,0,5,5
The Iron Lady,Won 2 Oscars. Another 23 wins & 47 nominations.,2,23,47,72
Hop,2 nominations.,0,0,2,2
Killer Elite,2 wins & 8 nominations,0,2,8,10
El esp�a que sab�a demasiado,,0,0,0,0
Real Steel,Nominated for 1 Oscar. Another 2 wins & 5 nominations.,1,2,5,8
Perfect Sense,3 wins & 3 nominations.,0,3,3,6
A Separation,1 win & 4 nominations.,0,1,4,5
Rio,Nominated for 1 Oscar. Another 3 wins & 30 nominations.,1,3,30,34
The Ides of March,Nominated for 1 Oscar. Another 9 wins & 34 nominations.,1,9,34,44
�Sabes qui�n viene?,,0,0,0,0
Rise of the Planet of the Apes,Nominated for 1 Oscar. 21 wins & 43 nominations total,1,21,43,65
Midnight in Paris,Won 1 Oscar. Another 25 wins & 103 nominations.,1,25,103,129
Courageous,2 wins & 3 nominations.,0,2,3,5
Mr. Popper's Penguins,1 win & 3 nominations,0,1,3,4
Transformers: Dark of the Moon,Nominated for 3 Oscars. Another 10 wins & 39 nominations.,3,10,39,52
Cowboys & Aliens,2 wins & 2 nominations.,0,2,2,4
Captain America: The First Avenger,4 wins & 46 nominations.,0,4,46,50
Winnie the Pooh,2 wins & 25 nominations,0,2,25,27
Your Highness,1 win & 3 nominations,0,1,3,4
Sherlock Holmes: A Game of Shadows,3 wins & 11 nominations.,0,3,11,14
The Twilight Saga: Breaking Dawn - Part 1,11 wins & 22 nominations.,0,11,22,33
W.E.,Nominated for 1 Oscar. 4 wins & 6 nominations total,1,4,6,11
Bernie,10 wins & 19 nominations.,0,10,19,29
Young Adult,Nominated for 1 Golden Globe. Another 3 wins & 32 nominations.,0,3,33,36
Agentes Secretos,,0,0,0,0
"Crazy, Stupid, Love.",4 wins & 23 nominations,0,4,23,27
Hugo,Won 5 Oscars. 61 wins & 192 nominations total,5,61,192,258
The Change-Up,1 nomination,0,0,1,1
Jumping the Broom,3 wins & 13 nominations.,0,3,13,16
No Strings Attached,2 wins & 6 nominations.,0,2,6,8
Apollo 18,1 win & 2 nominations.,0,1,2,3
The Inbetweeners Movie,,0,0,0,0
Contagion,2 wins & 14 nominations.,0,2,14,16
Cars 2,1 win & 19 nominations,0,1,19,20
The Tree of Life,Nominated for 3 Oscars. 116 wins & 129 nominations total,3,116,129,248
Rango,Won 1 Oscar. Another 45 wins & 25 nominations.,1,45,25,71
Texas Killing Fields,4 wins & 3 nominations.,0,4,3,7
Coriolanus,Nominated for 1 BAFTA Film Award. Another 10 wins & 17 nominations.,0,10,18,28
Beastly,1 win & 1 nomination.,0,1,1,2
Intruders,1 win & 5 nominations.,0,1,5,6
Rampart,2 wins & 6 nominations,0,2,6,8
Horrible Bosses,3 wins & 13 nominations.,0,3,13,16
We Need to Talk About Kevin,26 wins & 66 nominations total,0,26,66,92
The Eagle,1 nomination.,0,0,1,1
Source Code,1 win & 8 nominations.,0,1,8,9
Marmaduke,3 nominations.,0,0,3,3
Don't Be Afraid of the Dark,4 nominations.,0,0,4,4
Shrek Forever After,1 win & 13 nominations,0,1,13,14
Sex and the City 2,8 wins & 9 nominations.,0,8,9,17
She's Out of My League,1 nomination.,0,0,1,1
Shutter Island,11 wins & 66 nominations,0,11,66,77
The Crazies,11 nominations,0,0,11,11
Dinner for Schmucks,1 nomination,0,0,1,1
The Town,Nominated for 1 Oscar. Another 9 wins & 45 nominations.,1,9,45,55
Unstoppable,Nominated for 1 Oscar. Another 1 win & 13 nominations.,1,1,13,15
Hot Tub Time Machine,5 nominations.,0,0,5,5
The Secret World of Arrietty,12 wins & 6 nominations.,0,12,6,18
Dirty Girl,,0,0,0,0
Biutiful,Nominated for 2 Oscars. Another 21 wins & 62 nominations.,2,21,62,85
The Tourist,4 wins & 4 nominations.,0,4,4,8
Another Year,Nominated for 1 Oscar. Another 23 wins & 56 nominations.,1,23,56,80
Black Death,3 wins & 7 nominations.,0,3,7,10
The Kids Are All Right,Nominated for 4 Oscars. Another 29 wins & 129 nominations.,4,29,129,162
Ramona and Beezus,1 win & 4 nominations,0,1,4,5
The Killer Inside Me,2 wins & 5 nominations,0,2,5,7
The King's Speech,Won 4 Oscars. 108 wins & 206 nominations total,4,108,206,318
Life as We Know It,2 nominations.,0,0,2,2
Waiting for Forever,1 win & 1 nomination.,0,1,1,2
Robin Hood,1 win & 14 nominations.,0,1,14,15
Edge of Darkness,1 nomination,0,0,1,1
Rabbit Hole,Nominated for 1 Oscar. Another 7 wins & 41 nominations.,1,7,41,49
RED,4 wins & 19 nominations,0,4,19,23
The Sorcerer's Apprentice,1 win & 2 nominations.,0,1,2,3
The Last Airbender,8 wins & 12 nominations.,0,8,12,20
The Switch,1 win & 3 nominations.,0,1,3,4
The Last Circus,11 wins & 21 nominations.,0,11,21,32
Grown Ups,3 wins & 4 nominations.,0,3,4,7
Eat Pray Love,2 wins & 2 nominations,0,2,2,4
Wall Street: Money Never Sleeps,1 win & 4 nominations.,0,1,4,5
Megamind,2 wins & 16 nominations.,0,2,16,18
Sepultado,,0,0,0,0
The Spy Next Door,2 nominations.,0,0,2,2
In a Better World,,0,0,0,0
Elektra Luxx,1 nomination,0,0,1,1
Remember Me,4 wins & 5 nominations,0,4,5,9
El �ltimo exorcismo,,0,0,0,0
A Nightmare on Elm Street,4 wins & 5 nominations.,0,4,5,9
Blue Valentine,Nominated for 1 Oscar. Another 9 wins & 55 nominations.,1,9,55,65
Repo Men,2 nominations,0,0,2,2
Iron Man 2,Nominated for 1 Oscar. Another 7 wins & 43 nominations.,1,7,43,51
Green Zone,6 nominations.,0,0,6,6
Red Hill,6 nominations.,0,0,6,6
Resident Evil: Afterlife,2 wins & 8 nominations.,0,2,8,10
The Company Men,2 wins & 11 nominations.,0,2,11,13
Greenberg,2 wins & 15 nominations,0,2,15,17
The Conspirator,2 wins & 3 nominations,0,2,3,5
The Karate Kid,Nominated for 1 Oscar. Another 2 wins & 2 nominations.,1,2,2,5
The Social Network,Won 3 Oscars. Another 169 wins & 186 nominations.,3,169,186,358
Easy Money,,0,0,0,0
Easy A,9 wins & 21 nominations.,0,9,21,30
Welcome to the Rileys,2 wins & 3 nominations,0,2,3,5
Prince of Persia: The Sands of Time,1 win & 11 nominations.,0,1,11,12
Everything Must Go,1 nomination,0,0,1,1
Saw 3D: The Final Chapter,,0,0,0,0
Valentine's Day,7 wins & 12 nominations.,0,7,12,19
La versi�n de mi vida,,0,0,0,0
Get Him to the Greek,14 nominations,0,0,14,14
When in Rome,3 nominations.,0,0,3,3
Scott Pilgrim vs. the World,17 wins & 64 nominations.,0,17,64,81
Extraordinary Measures,1 win.,0,1,0,1
Secretariat,3 wins & 6 nominations.,0,3,6,9
Secretos Peligrosos,,0,0,0,0
Predators,2 wins & 4 nominations,0,2,4,6
Ip Man 2,,0,0,0,0
The Chronicles of Narnia: The Voyage of the Dawn Treader,2 wins & 18 nominations.,0,2,18,20
The Last Song,4 wins & 10 nominations,0,4,10,14
Salt,Nominated for 1 Oscar. Another 4 wins & 15 nominations.,1,4,15,20
Due Date,7 nominations.,0,0,7,7
Meek's Cutoff,7 wins & 14 nominations.,0,7,14,21
Dylan Dog: Dead of Night,1 nomination.,0,0,1,1
It's Kind of a Funny Story,2 nominations,0,0,2,2
Rubber,5 wins & 3 nominations.,0,5,3,8
A Little Help,2 nominations,0,0,2,2
Vanishing on 7th Street,,0,0,0,0
Gulliver's Travels,3 nominations,0,0,3,3
Black Swan,Won 1 Oscar. 97 wins & 279 nominations total,1,97,279,377
The Tempest,Nominated for 1 Oscar. 2 wins & 5 nominations total,1,2,5,8
Vampires Suck,7 nominations,0,0,7,7
La llave de Sarah,,0,0,0,0
Dear John,4 wins & 8 nominations.,0,4,8,12
Flipped,2 wins & 2 nominations,0,2,2,4
The Fighter,Won 2 Oscars. Another 71 wins & 124 nominations.,2,71,124,197
Yogi Bear,2 wins & 2 nominations.,0,2,2,4
Twelve,1 nomination.,0,0,1,1
Machete,2 wins & 6 nominations,0,2,6,8
You Again,2 wins.,0,2,0,2
All Good Things,1 nomination.,0,0,1,1
Tucker and Dale vs Evil,10 wins & 14 nominations.,0,10,14,24
London Boulevard,1 nomination.,0,0,1,1
MacGruber,2 nominations.,0,0,2,2
Submarine,Nominated for 1 BAFTA Film Award. Another 6 wins & 16 nominations.,0,6,17,23
Cop Out,1 nomination,0,0,1,1
Clash of the Titans,4 wins & 14 nominations,0,4,14,18
Stone,,0,0,0,0
Henry's Crime,,0,0,0,0
Inception,Won 4 Oscars. Another 153 wins & 220 nominations.,4,153,220,377
Legend of the Guardians: The Owls of Ga'Hoole,4 wins & 23 nominations.,0,4,23,27
Casino Jack,1 win & 2 nominations.,0,1,2,3
The A-Team,2 wins & 4 nominations.,0,2,4,6
Beyond the Black Rainbow,5 wins.,0,5,0,5
The Wolfman,Won 1 Oscar. 4 wins & 8 nominations total,1,4,8,13
The Book of Eli,3 wins & 16 nominations,0,3,16,19
Harry Potter and the Deathly Hallows: Part 1,Nominated for 2 Oscars. Another 15 wins & 53 nominations.,2,15,53,70
Insidious,8 wins & 15 nominations.,0,8,15,23
Monsters,14 wins & 14 nominations total,0,14,14,28
Date Night,4 wins & 8 nominations,0,4,8,12
Step Up 3D,2 nominations,0,0,2,2
Toy Story 3,Won 2 Oscars. Another 59 wins & 96 nominations.,2,59,96,157
Conviction,9 wins & 9 nominations.,0,9,9,18
Last Night,4 nominations,0,0,4,4
Cyrus,6 nominations,0,0,6,6
You Will Meet a Tall Dark Stranger,2 wins & 6 nominations.,0,2,6,8
Knight and Day,3 nominations.,0,0,3,3
Love & Other Drugs,2 wins & 1 nomination.,0,2,1,3
TRON: Legacy,Nominated for 1 Oscar. Another 10 wins & 50 nominations.,1,10,50,61
Leap Year,,0,0,0,0
Frankie & Alice,6 nominations.,0,0,6,6
Takers,2 wins & 6 nominations.,0,2,6,8
Trollhunter,12 wins & 13 nominations.,0,12,13,25
Alpha and Omega,1 nomination,0,0,1,1
How to Train Your Dragon,Nominated for 2 Oscars. Another 25 wins & 61 nominations.,2,25,61,88
I'm Still Here,1 win & 4 nominations.,0,1,4,5
The Way,1 win & 8 nominations.,0,1,8,9
The Expendables,3 wins & 5 nominations.,0,3,5,8
Tangled,Nominated for 1 Oscar. Another 10 wins & 40 nominations.,1,10,40,51
Four Lions,Won 1 BAFTA Film Award. Another 8 wins & 24 nominations.,0,9,24,33
The Way Back,Nominated for 1 Oscar. Another 4 wins & 4 nominations.,1,4,4,9
Nanny McPhee Returns,,0,0,0,0
Love Ranch,1 win & 1 nomination.,0,1,1,2
True Grit,Nominated for 10 Oscars. 38 wins & 169 nominations total,10,38,169,217
The Bounty Hunter,4 wins & 5 nominations,0,4,5,9
The Next Three Days,3 nominations,0,0,3,3
I Spit on Your Grave,2 nominations.,0,0,2,2
Country Strong,Nominated for 1 Oscar. Another 1 win & 7 nominations.,1,1,7,9
The Other Guys,3 wins & 15 nominations,0,3,15,18
The Warrior's Way,1 win,0,1,0,1
Super,1 win.,0,1,0,1
For Colored Girls,14 wins & 17 nominations.,0,14,17,31
Killers,2 wins & 3 nominations.,0,2,3,5
Hatchet II,4 nominations.,0,0,4,4
The Romantics,,0,0,0,0
Tamara Drewe,3 wins & 3 nominations.,0,3,3,6
Legion,,0,0,0,0
The Runaways,6 nominations.,0,0,6,6
Winter's Bone,Nominated for 4 Oscars. Another 63 wins & 127 nominations.,4,63,127,194
The Debt,13 wins & 5 nominations.,0,13,5,18
The Perfect Host,3 wins,0,3,0,3
Beginners,Won 1 Oscar. Another 35 wins & 30 nominations.,1,35,30,66
My Name Is Khan,23 wins & 26 nominations.,0,23,26,49
13 Assassins,15 wins & 28 nominations.,0,15,28,43
Passion Play,,0,0,0,0
Tooth Fairy,1 win & 4 nominations.,0,1,4,5
Happythankyoumoreplease,1 win & 3 nominations.,0,1,3,4
Somewhere,4 wins & 8 nominations.,0,4,8,12
Let Me In,14 wins & 28 nominations.,0,14,28,42
Kick-Ass,19 wins & 62 nominations,0,19,62,81
The Losers,1 win & 7 nominations,0,1,7,8
The Back-up Plan,2 nominations.,0,0,2,2
Devil,2 nominations,0,0,2,2
Hereafter,Nominated for 1 Oscar. Another 4 wins & 14 nominations.,1,4,14,19
Diary of a Wimpy Kid,5 wins & 9 nominations,0,5,9,14
Piranha 3D,2 wins & 12 nominations.,0,2,12,14
Going the Distance,,0,0,0,0
Faster,5 nominations,0,0,5,5
Skyline,1 nomination.,0,0,1,1
Wild Target,,0,0,0,0
Centurion,1 nomination,0,0,1,1
Hesher,1 win & 1 nomination.,0,1,1,2
Despicable Me,Nominated for 1 BAFTA Film Award. Another 3 wins & 40 nominations.,0,3,41,44
Little Fockers,3 wins & 5 nominations,0,3,5,8
How Do You Know,3 nominations.,0,0,3,3
The Twilight Saga: Eclipse,22 wins & 34 nominations.,0,22,34,56
Jonah Hex,1 win & 4 nominations.,0,1,4,5
Letters to Juliet,6 nominations,0,0,6,6
Burlesque,Won 1 Golden Globe. Another 5 wins & 19 nominations.,0,6,19,25
Cats & Dogs: The Revenge of Kitty Galore,11 wins & 7 nominations.,0,11,7,18
127 Hours,Nominated for 6 Oscars. Another 23 wins & 144 nominations.,6,23,144,173
Paranormal Activity 2,1 win & 2 nominations.,0,1,2,3
The Ghost Writer,33 wins & 55 nominations.,0,33,55,88
Alice in Wonderland,Won 2 Oscars. Another 33 wins & 63 nominations.,2,33,63,98
Burke and Hare,1 nomination,0,0,1,1
Charlie St. Cloud,4 nominations,0,0,4,4
Made in Dagenham,3 wins & 17 nominations total,0,3,17,20
My Soul to Take,1 nomination,0,0,1,1
The American,4 nominations.,0,0,4,4
The Man from Nowhere,,0,0,0,0
Animal Kingdom,Nominated for 1 Oscar. Another 39 wins & 59 nominations.,1,39,59,99
Incendies,Nominated for 1 Oscar. Another 39 wins & 16 nominations.,1,39,16,56
Par�s en la Mira,,0,0,0,0
Furry Vengeance,1 win & 1 nomination,0,1,1,2
Stake Land,3 wins & 11 nominations.,0,3,11,14
Never Let Me Go,8 wins & 27 nominations.,0,8,27,35
3 Idiots,64 wins & 23 nominations.,0,64,23,87
The Pink Panther 2,3 nominations,0,0,3,3
Night at the Museum: Battle of the Smithsonian,2 wins & 9 nominations.,0,2,9,11
The Proposal,7 wins & 20 nominations,0,7,20,27
Friday the 13th,5 nominations.,0,0,5,5
The Soloist,1 win & 3 nominations,0,1,3,4
Ninja Assassin,,0,0,0,0
The Joneses,1 nomination,0,0,1,1
Youth in Revolt,1 win & 1 nomination.,0,1,1,2
G.I. Joe: The Rise of Cobra,3 wins & 16 nominations,0,3,16,19
G-Force,1 win & 1 nomination.,0,1,1,2
New in Town,,0,0,0,0
Zombieland,10 wins & 29 nominations,0,10,29,39
Race to Witch Mountain,1 nomination.,0,0,1,1
Inglourious Basterds,Won 1 Oscar. Another 132 wins & 172 nominations.,1,132,172,305
The Invention of Lying,1 nomination,0,0,1,1
2012,5 wins & 21 nominations.,0,5,21,26
Funny People,3 nominations.,0,0,3,3
Middle Men,,0,0,0,0
Nine,Nominated for 4 Oscars. Another 8 wins & 56 nominations.,4,8,56,68
17 Again,3 wins & 5 nominations,0,3,5,8
Ghosts of Girlfriends Past,1 win.,0,1,0,1
Pirate Radio,1 win.,0,1,0,1
Gamer,1 win.,0,1,0,1
Whip It,8 nominations.,0,0,8,8
Fame,Won 2 Oscars. Another 5 wins & 16 nominations.,2,5,16,23
The Limits of Control,1 win,0,1,0,1
World's Greatest Dad,1 nomination,0,0,1,1
My Sister's Keeper,4 wins & 4 nominations.,0,4,4,8
Fighting,1 nomination.,0,0,1,1
X-Men Origins: Wolverine,3 wins & 21 nominations.,0,3,21,24
Miss March,2 nominations.,0,0,2,2
Push,1 win & 2 nominations.,0,1,2,3
Precious,Won 2 Oscars. Another 111 wins & 103 nominations.,2,111,103,216
Hotel para perros,,0,0,0,0
500 Days of Summer,Nominated for 2 Golden Globes. Another 17 wins & 56 nominations.,0,17,58,75
Black Dynamite,1 win & 4 nominations,0,1,4,5
Fired Up!,1 nomination,0,0,1,1
Extract,,0,0,0,0
Fanboys,,0,0,0,0
Planeta 51,,0,0,0,0
9,9 nominations.,0,0,9,9
My Life in Ruins,1 nomination.,0,0,1,1
My Bloody Valentine,4 nominations,0,0,4,4
The Princess and the Frog,Nominated for 3 Oscars. Another 10 wins & 39 nominations.,3,10,39,52
The Lovely Bones,Nominated for 1 Oscar. Another 10 wins & 45 nominations.,1,10,45,56
Bitch Slap,,0,0,0,0
Whiteout,,0,0,0,0
Fantastic Mr. Fox,Nominated for 2 Oscars. Another 32 wins & 61 nominations.,2,32,61,95
Perrier's Bounty,3 nominations.,0,0,3,3
The Secret in Their Eyes,Won 1 Oscar. Another 52 wins & 43 nominations.,1,52,43,96
A Christmas Carol,3 wins & 5 nominations.,0,3,5,8
Invictus,Nominated for 2 Oscars. 12 wins & 37 nominations total,2,12,37,51
[Rec] 2,,0,0,0,0
Bad Lieutenant: Port of Call New Orleans,3 wins & 13 nominations.,0,3,13,16
Paper Man,1 win.,0,1,0,1
Pandorum,,0,0,0,0
Fast & Furious,10 wins & 22 nominations.,0,10,22,32
Mr. Nobody,11 wins & 6 nominations.,0,11,6,17
12 Rounds,,0,0,0,0
Notorious,Nominated for 2 Oscars. Another 3 wins & 1 nomination.,2,3,1,6
The Last House on the Left,1 win & 8 nominations.,0,1,8,9
Get Low,4 wins & 28 nominations.,0,4,28,32
Public Enemies,1 win & 14 nominations,0,1,14,15
Nowhere Boy,Nominated for 3 BAFTA Film Awards. Another 6 wins & 18 nominations.,0,6,21,27
Observe and Report,1 win & 4 nominations.,0,1,4,5
Obsessed,4 wins & 8 nominations.,0,4,8,12
Old Dogs,5 nominations,0,0,5,5
Ondine,6 wins & 6 nominations,0,6,6,12
The Slammin' Salmon,,0,0,0,0
Mystery Team,,0,0,0,0
Knowing,1 win & 6 nominations,0,1,6,7
Orphan,1 win & 7 nominations.,0,1,7,8
The Last Station,Nominated for 2 Oscars. 5 wins & 18 nominations total,2,5,18,25
The Messenger,Nominated for 2 Oscars. Another 17 wins & 44 nominations.,2,17,44,63
Moon,Won 1 BAFTA Film Award. Another 27 wins & 37 nominations.,0,28,37,65
Monsters vs. Aliens,3 wins & 10 nominations.,0,3,10,13
The Men Who Stare at Goats,1 win & 1 nomination,0,1,1,2
Year One,1 nomination,0,0,1,1
The Road,5 wins & 34 nominations total,0,5,34,39
Whatever Works,2 wins & 1 nomination,0,2,1,3
Beyond a Reasonable Doubt,,0,0,0,0
Paul Blart: Mall Cop,1 win & 3 nominations.,0,1,3,4
The Human Centipede (First Sequence),8 wins & 3 nominations.,0,8,3,11
I Can Do Bad All by Myself,1 win & 5 nominations.,0,1,5,6
Tanner Hall,2 wins.,0,2,0,2
Terminator Salvation,2 wins & 14 nominations.,0,2,14,16
The Time Traveler's Wife,1 win & 5 nominations.,0,1,5,6
Coraline,Nominated for 1 Oscar. Another 8 wins & 45 nominations.,1,8,45,54
Summer Wars,10 wins & 5 nominations.,0,10,5,15
The Haunting in Connecticut,1 win & 2 nominations.,0,1,2,3
The Girlfriend Experience,1 nomination,0,0,1,1
Sector 9,1 win.,0,1,0,1
The White Ribbon,Nominated for 2 Oscars. Another 62 wins & 46 nominations.,2,62,46,110
I Hope They Serve Beer in Hell,,0,0,0,0
Couples Retreat,1 win & 4 nominations,0,1,4,5
Donde viven los monstruos,,0,0,0,0
All About Steve,2 wins & 3 nominations.,0,2,3,5
The Hangover,Won 1 Golden Globe. Another 12 wins & 25 nominations.,0,13,25,38
Armored,,0,0,0,0
Tetro,1 win & 5 nominations.,0,1,5,6
Drag Me to Hell,7 wins & 24 nominations.,0,7,24,31
Julie & Julia,Nominated for 2 Oscars. 2 nominations total,0,2,2,4
The House of the Devil,3 wins & 6 nominations,0,3,6,9
Today's Special,,0,0,0,0
The Disappearance of Alice Creed,1 win & 6 nominations.,0,1,6,7
After.Life,1 nomination.,0,0,1,1
Law Abiding Citizen,3 wins & 5 nominations.,0,3,5,8
Case 39,3 nominations.,0,0,3,3
Avatar,Won 3 Oscars. Another 86 wins & 130 nominations.,3,86,130,219
Defendor,1 win & 7 nominations.,0,1,7,8
Solitary Man,2 wins & 3 nominations,0,2,3,5
Carriers,1 nomination.,0,0,1,1
Street Fighter: La leyenda,,0,0,0,0
Dragonball: Evolution,1 nomination.,0,0,1,1
Cracks,3 nominations.,0,0,3,3
Bride Wars,1 win & 8 nominations.,0,1,8,9
"I Love You, Man",1 win & 8 nominations.,0,1,8,9
Transformers: Revenge of the Fallen,Nominated for 1 Oscar. Another 15 wins & 30 nominations.,1,15,30,46
Adventureland,1 win & 4 nominations,0,1,4,5
The Good Guy,,0,0,0,0
Shorts,1 win & 1 nomination.,0,1,1,2
Surrogates,,0,0,0,0
"The Goods: Live Hard, Sell Hard",,0,0,0,0
Crossing Over,1 win.,0,1,0,1
Survival of the Dead,2 nominations,0,0,2,2
Br�no,,0,0,0,0
Did You Hear About the Morgans?,2 nominations.,0,0,2,2
Land of the Lost,2 wins & 9 nominations.,0,2,9,11
Broken Embraces,Nominated for 1 Golden Globe. Another 9 wins & 45 nominations.,0,9,46,55
Love and Other Impossible Pursuits,,0,0,0,0
Hannah Montana: The Movie,6 wins & 10 nominations.,0,6,10,16
Brooklyn's Finest,1 win & 10 nominations.,0,1,10,11
Brothers,Nominated for 2 Golden Globes. Another 4 wins & 14 nominations.,0,4,16,20
Sherlock Holmes,Nominated for 2 Oscars. 10 wins & 31 nominations total,2,10,31,43
Love Happens,1 win.,0,1,0,1
Bright Star,Nominated for 1 Oscar. Another 16 wins & 53 nominations.,1,16,53,70
Crazy Heart,Won 2 Oscars. 39 wins & 33 nominations total,2,39,33,74
Crank: High Voltage,1 win & 2 nominations.,0,1,2,3
Astro Boy,4 nominations.,0,0,4,4
Underworld: Rise of the Lycans,2 nominations.,0,0,2,2
Adam,2 wins & 2 nominations,0,2,2,4
Halloween II,1 win & 3 nominations.,0,1,3,4
Up in the Air,Nominated for 6 Oscars. Another 75 wins & 164 nominations.,6,75,164,245
District 13: Ultimatum,,0,0,0,0
Alvin and the Chipmunks: The Squeakquel,3 wins.,0,3,0,3
Taking Woodstock,8 nominations,0,0,8,8
Up,Won 2 Oscars. 79 wins & 87 nominations total,2,79,87,168
Agora,11 wins & 15 nominations,0,11,15,26
I Am Love,,0,0,0,0
Amelia,3 wins & 4 nominations.,0,3,4,7
Una pareja dispareja,,0,0,0,0
Confessions of a Shopaholic,1 win & 3 nominations.,0,1,3,4
A �l no le gustas tanto,,0,0,0,0
Thirst,17 wins & 19 nominations.,0,17,19,36
Ch�ri,,0,0,0,0
Cirque du Freak: The Vampire's Assistant,1 win.,0,1,0,1
Star Trek,Won 1 Oscar. 27 wins & 95 nominations total,1,27,95,123
City Island,3 wins & 4 nominations.,0,3,4,7
The Fourth Kind,1 nomination.,0,0,1,1
The Box,6 nominations,0,0,6,6
Aliens in the Attic,2 nominations,0,0,2,2
"I Love You, Beth Cooper",1 win & 1 nomination,0,1,1,2
The Imaginarium of Doctor Parnassus,Nominated for 2 Oscars. Another 5 wins & 21 nominations.,2,5,21,28
The Damned United,5 nominations.,0,0,5,5
The Final Destination,2 wins & 2 nominations.,0,2,2,4
Angels & Demons,1 win & 5 nominations,0,1,5,6
A Single Man,Nominated for 1 Oscar. Another 39 wins & 57 nominations.,1,39,57,97
A Serious Man,Nominated for 2 Oscars. 17 wins & 80 nominations total,2,17,80,99
Ice Age: Dawn of the Dinosaurs,3 wins & 13 nominations.,0,3,13,16
The Blind Side,Won 1 Oscar. Another 8 wins & 30 nominations.,1,8,30,39
A Perfect Getaway,1 nomination.,0,0,1,1
State of Play,2 wins & 4 nominations,0,2,4,6
The Collector,,0,0,0,0
Watchmen,11 wins & 24 nominations.,0,11,24,35
Harry Brown,1 win & 4 nominations,0,1,4,5
Harry Potter and the Half-Blood Prince,Nominated for 1 Oscar. Another 9 wins & 38 nominations.,1,9,38,48
The International,1 win & 1 nomination.,0,1,1,2
Chloe,3 wins & 5 nominations.,0,3,5,8
The Informant!,1 win & 20 nominations,0,1,20,21
A Prophet,Nominated for 1 Oscar. Another 52 wins & 54 nominations.,1,52,54,107
El juego del miedo VI,,0,0,0,0
The Canyon,,0,0,0,0
The Uninvited,2 nominations.,0,0,2,2
The Young Victoria,Won 1 Oscar. 13 wins & 17 nominations total,1,13,17,31
The Boondock Saints II: All Saints Day,,0,0,0,0
It's Complicated,8 wins & 15 nominations total,0,8,15,23
The Taking of Pelham 123,1 win & 7 nominations.,0,1,7,8
An Education,Nominated for 3 Oscars. 36 wins & 96 nominations total,3,36,96,135
Sorority Row,2 nominations.,0,0,2,2
The Girl Who Played with Fire,1 win & 4 nominations.,0,1,4,5
Madea Goes to Jail,1 win & 4 nominations.,0,1,4,5
La hermandad,,0,0,0,0
Away We Go,3 wins & 10 nominations.,0,3,10,13
Duplicity,1 win & 4 nominations.,0,1,4,5
Arthur and the Revenge of Maltazard,,0,0,0,0
The Girl Who Kicked the Hornet's Nest,1 win & 3 nominations.,0,1,3,4
Jennifer's Body,3 wins & 4 nominations.,0,3,4,7
Coco Before Chanel,Nominated for 1 Oscar. Another 5 wins & 19 nominations.,1,5,19,25
Splice: experimento mortal,,0,0,0,0
Sin Nombre,14 wins & 18 nominations.,0,14,18,32
The Twilight Saga: New Moon,20 wins & 24 nominations.,0,20,24,44
The Ugly Truth,3 wins & 5 nominations.,0,3,5,8
Spread,,0,0,0,0
Cloudy with a Chance of Meatballs,1 win & 14 nominations.,0,1,14,15
Street Kings,1 nomination.,0,0,1,1
Step Brothers,3 wins & 2 nominations.,0,3,2,5
The Mummy: Tomb of the Dragon Emperor,2 wins & 6 nominations.,0,2,6,8
Sunshine Cleaning,2 wins & 6 nominations.,0,2,6,8
I Can't Think Straight,3 wins & 1 nomination.,0,3,1,4
The Merry Gentleman,3 wins & 1 nomination.,0,3,1,4
Oorlogswinter,10 wins & 9 nominations,0,10,9,19
Fool's Gold,5 nominations,0,0,5,5
Surveillance,3 wins & 5 nominations.,0,3,5,8
Strange Wilderness,,0,0,0,0
Step Up 2: The Streets,2 wins & 3 nominations.,0,2,3,5
Two Lovers,3 wins & 18 nominations.,0,3,18,21
The Family That Preys,3 wins & 7 nominations.,0,3,7,10
Yes Man,3 wins & 9 nominations,0,3,9,12
Cadillac Records,6 wins & 21 nominations,0,6,21,27
One Missed Call,2 nominations.,0,0,2,2
Over Her Dead Body,,0,0,0,0
"Surfer, Dude",,0,0,0,0
The Wackness,4 wins & 4 nominations,0,4,4,8
The Forbidden Kingdom,5 nominations.,0,0,5,5
The Midnight Meat Train,2 wins & 6 nominations.,0,2,6,8
Beverly Hills Chihuahua,3 wins & 6 nominations.,0,3,6,9
Stop-Loss,2 wins & 5 nominations,0,2,5,7
Superhero Movie,1 win.,0,1,0,1
You Don't Mess with the Zohan,2 wins & 2 nominations,0,2,2,4
Death Race,1 win & 5 nominations.,0,1,5,6
Forever Strong,1 win.,0,1,0,1
Killshot,,0,0,0,0
Chaos Theory,1 nomination,0,0,1,1
The Wrestler,Nominated for 2 Oscars. 58 wins & 93 nominations total,2,58,93,153
Changeling,Nominated for 3 Oscars. Another 14 wins & 51 nominations.,3,14,51,68
The Dark Knight,Won 2 Oscars. Another 157 wins & 163 nominations.,2,157,163,322
The Day the Earth Stood Still,2 wins & 5 nominations,0,2,5,7
Cloverfield,5 wins & 34 nominations.,0,5,34,39
The Bank Job,3 nominations.,0,0,3,3
Ghost Town,3 wins & 2 nominations,0,3,2,5
Hellboy II: The Golden Army,Nominated for 1 Oscar. Another 5 wins & 34 nominations.,1,5,34,40
The Baader Meinhof Complex,Nominated for 1 Oscar. Another 4 wins & 20 nominations.,1,4,20,25
Journey to the Center of the Earth,3 wins & 4 nominations.,0,3,4,7
Let the Right One In,Nominated for 1 BAFTA Film Award. Another 75 wins & 57 nominations.,0,75,58,133
Ceguera,,0,0,0,0
Frost/Nixon,Nominated for 5 Oscars. 23 wins & 80 nominations total,5,23,80,108
Bedtime Stories,3 wins & 5 nominations,0,3,5,8
The Boy in the Striped Pajamas,,0,0,0,0
Swing Vote,1 nomination.,0,0,1,1
Choke,2 wins & 7 nominations,0,2,7,9
Get Smart,3 wins & 6 nominations.,0,3,6,9
The Class,7 wins & 2 nominations.,0,7,2,9
The Chronicles of Narnia: Prince Caspian,2 wins & 21 nominations,0,2,21,23
The Curious Case of Benjamin Button,Won 3 Oscars. Another 80 wins & 160 nominations.,3,80,160,243
Mutant Chronicles,,0,0,0,0
My Best Friend's Girl,1 nomination.,0,0,1,1
"10,000 BC",,0,0,0,0
The X Files: I Want to Believe,,0,0,0,0
The Burning Plain,2 wins & 3 nominations,0,2,3,5
The Brothers Bloom,3 nominations.,0,0,3,3
City of Ember,6 nominations.,0,0,6,6
Hell Ride,1 win.,0,1,0,1
Never Back Down,1 win,0,1,0,1
College,,0,0,0,0
The Express,1 win & 3 nominations.,0,1,3,4
The Other Boleyn Girl,3 nominations,0,0,3,3
Kit Kittredge: An American Girl,2 wins & 5 nominations,0,2,5,7
27 Dresses,5 wins & 3 nominations.,0,5,3,8
The Red Baron,2 nominations.,0,0,2,2
High School Musical 3: Senior Year,8 wins & 9 nominations.,0,8,9,17
Transsiberian,2 wins & 11 nominations.,0,2,11,13
Tropic Thunder,Nominated for 1 Oscar. Another 10 wins & 46 nominations.,1,10,46,57
College Road Trip,1 nomination.,0,0,1,1
Nothing But the Truth,2 wins & 2 nominations.,0,2,2,4
"Synecdoche, New York",8 wins & 29 nominations,0,8,29,37
Indiana Jones and the Kingdom of the Crystal Skull,Nominated for 1 BAFTA Film Award. Another 10 wins & 41 nominations.,0,10,42,52
Forgetting Sarah Marshall,4 wins & 19 nominations,0,4,19,23
The Edge of Love,1 win & 2 nominations.,0,1,2,3
21,1 win & 5 nominations,0,1,5,6
Zack and Miri Make a Porno,2 wins & 4 nominations,0,2,4,6
Be Kind Rewind,4 nominations.,0,0,4,4
The Reader,Won 1 Oscar. 26 wins & 48 nominations total,1,26,48,75
Leatherheads,1 win & 3 nominations.,0,1,3,4
Appaloosa,4 wins.,0,4,0,4
Traitor,5 nominations.,0,0,5,5
The Oxford Murders,6 wins & 5 nominations,0,6,5,11
Nim's Island,2 wins & 3 nominations.,0,2,3,5
Nights in Rodanthe,1 nomination,0,0,1,1
The Duchess,Won 1 Oscar. Another 7 wins & 21 nominations.,1,7,21,29
Jumper,2 wins & 5 nominations,0,2,5,7
Nick and Norah's Infinite Playlist,9 nominations,0,0,9,9
Ni en tu casa ni en la m�a,,0,0,0,0
The Women,4 wins & 4 nominations.,0,4,4,8
"New York, I Love You",1 nomination,0,0,1,1
How to Lose Friends & Alienate People,,0,0,0,0
What Happens in Vegas,5 nominations,0,0,5,5
Max Payne,1 nomination,0,0,1,1
Vantage Point,2 wins & 2 nominations.,0,2,2,4
In Bruges,Nominated for 1 Oscar. Another 24 wins & 54 nominations.,1,24,54,79
Miracle at St. Anna,1 win & 10 nominations.,0,1,10,11
Vicky Cristina Barcelona,Won 1 Oscar. 32 wins & 54 nominations total,1,32,54,87
Me and Orson Welles,Nominated for 1 BAFTA Film Award. Another 5 wins & 26 nominations.,0,5,27,32
Eagle Eye,3 wins & 8 nominations,0,3,8,11
What Just Happened,1 nomination.,0,0,1,1
Punisher: War Zone,1 win & 1 nomination,0,1,1,2
The Tale of Despereaux,1 win & 8 nominations,0,1,8,9
Milk,Won 2 Oscars. Another 64 wins & 144 nominations.,2,64,144,210
Easy Virtue,2 wins & 6 nominations.,0,2,6,8
RocknRolla,1 win & 5 nominations.,0,1,5,6
Prom Night,1 win & 4 nominations.,0,1,4,5
The House Bunny,2 nominations.,0,0,2,2
Quarantine,6 nominations.,0,0,6,6
Mad Money,2 nominations.,0,0,2,2
Kung Fu Panda,Nominated for 1 Oscar. Another 14 wins & 38 nominations.,1,14,38,53
Doubt,Nominated for 5 Oscars. 25 wins & 96 nominations total,5,25,96,126
The Haunting of Molly Hartley,1 nomination.,0,0,1,1
Pretty Ugly People,2 wins.,0,2,0,2
Saw V,1 win & 2 nominations,0,1,2,3
Pride and Glory,2 nominations,0,0,2,2
Mirrors,2 nominations.,0,0,2,2
Bottle Shock,1 nomination,0,0,1,1
Valkyrie,3 wins & 11 nominations.,0,3,11,14
Dream Boy,2 wins,0,2,0,2
Australia,Nominated for 1 Oscar. Another 12 wins & 35 nominations.,1,12,35,48
The Sisterhood of the Traveling Pants 2,1 nomination,0,0,1,1
Drillbit Taylor,1 win & 2 nominations.,0,1,2,3
The Hottie & the Nottie,4 wins & 4 nominations.,0,4,4,8
Quantum of Solace,Nominated for 2 BAFTA Film Awards. Another 4 wins & 30 nominations.,0,4,32,36
Meet Dave,2 wins & 3 nominations.,0,2,3,5
Doomsday,1 nomination,0,0,1,1
Babylon A.D.,1 nomination.,0,0,1,1
Gran Torino,21 wins & 22 nominations.,0,21,22,43
The Incredible Hulk,1 win & 10 nominations.,0,1,10,11
The Stoning of Soraya M.,8 wins & 8 nominations.,0,8,8,16
Wanted,Nominated for 2 Oscars. 4 wins & 25 nominations total,2,4,25,31
Red Cliff,14 wins & 44 nominations.,0,14,44,58
The Informers,,0,0,0,0
El libro m�gico,,0,0,0,0
Body of Lies,2 nominations.,0,0,2,2
"War, Inc.",1 nomination.,0,0,1,1
Repo! The Genetic Opera,3 wins & 1 nomination.,0,3,1,4
Baby Mama,1 win & 5 nominations.,0,1,5,6
El transportador 3,,0,0,0,0
Redbelt,1 nomination.,0,0,1,1
Elegy,3 wins & 5 nominations,0,3,5,8
Waltz with Bashir,Nominated for 1 Oscar. Another 45 wins & 62 nominations.,1,45,62,108
The Spirit,4 nominations,0,0,4,4
Bolt,Nominated for 1 Oscar. Another 1 win & 31 nominations.,1,1,31,33
Righteous Kill,1 win & 2 nominations.,0,1,2,3
W.,1 win & 8 nominations.,0,1,8,9
WALL�E,Won 1 Oscar. Another 92 wins & 95 nominations.,1,92,95,188
Horton Hears a Who!,1 win & 18 nominations.,0,1,18,19
"Welcome Home, Roscoe Jenkins",,0,0,0,0
Eden Lake,9 wins & 8 nominations.,0,9,8,17
The Hurt Locker,Won 6 Oscars. 125 wins & 130 nominations total,6,125,130,261
Iron Man,Nominated for 2 Oscars. Another 21 wins & 71 nominations.,2,21,71,94
Meet the Spartans,6 nominations.,0,0,6,6
The Spiderwick Chronicles,2 wins & 8 nominations.,0,2,8,10
Rachel Getting Married,Nominated for 1 Oscar. Another 32 wins & 64 nominations.,1,32,64,97
The Strangers,1 win & 15 nominations.,0,1,15,16
Meet the Browns,3 nominations.,0,0,3,3
Rambo 4: Regreso al Infierno,,0,0,0,0
Revolutionary Road,Nominated for 3 Oscars. Another 20 wins & 70 nominations.,3,20,70,93
Good Dick,1 win & 1 nomination.,0,1,1,2
The Happening,3 wins & 10 nominations.,0,3,10,13
The Secret Life of Bees,11 wins & 17 nominations.,0,11,17,28
Bangkok Dangerous,1 nomination.,0,0,1,1
Bronson,3 wins & 7 nominations.,0,3,7,10
Pineapple Express,2 wins & 15 nominations.,0,2,15,17
Igor,1 nomination.,0,0,1,1
The Good the Bad the Weird,12 wins & 27 nominations.,0,12,27,39
The Love Guru,5 wins & 8 nominations,0,5,8,13
Slumdog Millionaire,Won 8 Oscars. Another 145 wins & 133 nominations.,8,145,133,286
"Definitely, Maybe",1 win & 1 nomination.,0,1,1,2
Defiance,Nominated for 1 Oscar. 2 wins & 5 nominations total,1,2,5,8
Felon,,0,0,0,0
Happy-Go-Lucky,Nominated for 1 Oscar. Another 39 wins & 62 nominations.,1,39,62,102
Pathology,,0,0,0,0
Deception,1 nomination,0,0,1,1
Made of Honor,1 win & 1 nomination.,0,1,1,2
The Ruins,7 nominations,0,0,7,7
Soul Men,3 nominations.,0,0,3,3
Mesrine Part 1: Killer Instinct,,0,0,0,0
Speed Racer,1 win & 12 nominations.,0,1,12,13
Madagascar: Escape 2 Africa,4 wins & 11 nominations,0,4,11,15
Burn After Reading,8 wins & 32 nominations total,0,8,32,40
Un par nada ejemplar,,0,0,0,0
Fireflies in the Garden,1 nomination.,0,0,1,1
Fireproof,1 win.,0,1,0,1
The Rocker,,0,0,0,0
First Sunday,,0,0,0,0
Harold & Kumar Escape from Guantanamo Bay,,0,0,0,0
B�squeda implacable,,0,0,0,0
Hancock,4 wins & 14 nominations.,0,4,14,18
Mamma Mia!,15 wins & 25 nominations.,0,15,25,40
Brideshead Revisited,11 nominations,0,0,11,11
Semi-Pro,1 win & 4 nominations.,0,1,4,5
Ponyo,12 wins & 20 nominations.,0,12,20,32
Sex Drive,,0,0,0,0
Untraceable,1 win,0,1,0,1
Miss Pettigrew Lives for a Day,1 nomination.,0,0,1,1
Marley & Me,Nominated for 1 BAFTA Film Award. Another 1 win & 7 nominations.,0,1,8,9
Sex and the City,2 wins & 12 nominations,0,2,12,14
Disaster Movie,1 win & 6 nominations.,0,1,6,7
Lakeview Terrace,1 nomination,0,0,1,1
Hamlet 2,3 nominations.,0,0,3,3
Donkey Punch,5 nominations,0,0,5,5
Shutter,1 win & 1 nomination.,0,1,1,2
Seven Pounds,4 wins & 7 nominations.,0,4,7,11
Wild Child,,0,0,0,0
Harry Potter and the Order of the Phoenix,Nominated for 2 BAFTA Film Awards. Another 16 wins & 45 nominations.,0,16,47,63
License to Wed,1 nomination.,0,0,1,1
Michael Clayton,Won 1 Oscar. Another 27 wins & 114 nominations.,1,27,114,142
Gone Baby Gone,Nominated for 1 Oscar. Another 33 wins & 31 nominations.,1,33,31,65
I Know Who Killed Me,8 wins & 4 nominations,0,8,4,12
Hot Fuzz,2 wins & 9 nominations.,0,2,9,11
Ghost Rider,1 win & 11 nominations.,0,1,11,12
Halloween,8 wins & 2 nominations.,0,8,2,10
Like Stars on Earth,,0,0,0,0
Hounddog,2 wins & 1 nomination.,0,2,1,3
Mongol: The Rise of Genghis Khan,Nominated for 1 Oscar. Another 15 wins & 11 nominations.,1,15,11,27
Martian Child,2 nominations,0,0,2,2
Juno,Won 1 Oscar. Another 88 wins & 99 nominations.,1,88,99,188
I Now Pronounce You Chuck & Larry,14 nominations.,0,0,14,14
La Vie en Rose,,0,0,0,0
Mi mascota es un monstruo,,0,0,0,0
Good Luck Chuck,1 win & 3 nominations.,0,1,3,4
Grindhouse,10 wins & 22 nominations,0,10,22,32
In the Valley of Elah,Nominated for 1 Oscar. Another 3 wins & 20 nominations.,1,3,20,24
Lions for Lambs,3 nominations.,0,0,3,3
Live Free or Die Hard,3 wins & 16 nominations,0,3,16,19
I Think I Love My Wife,1 nomination,0,0,1,1
Hannibal Rising,2 nominations,0,0,2,2
In the Land of Women,,0,0,0,0
Knocked Up,8 wins & 26 nominations.,0,8,26,34
Hitman - Agente 47,,0,0,0,0
Love in the Time of Cholera,Nominated for 1 Golden Globe. Another 3 nominations.,0,0,4,4
I Am Legend,9 wins & 23 nominations,0,9,23,32
Mr. Bean's Holiday,2 nominations.,0,0,2,2
Mr. Brooks,2 nominations,0,0,2,2
Lars and the Real Girl,Nominated for 1 Oscar. Another 7 wins & 35 nominations.,1,7,35,43
Meet the Robinsons,1 win & 10 nominations,0,1,10,11
In the Name of the King: A Dungeon Siege Tale,4 wins & 5 nominations.,0,4,5,9
Lucky You,2 nominations.,0,0,2,2
"Lust, Caution",Nominated for 1 Golden Globe. Another 29 wins & 54 nominations.,0,29,55,84
Margot at the Wedding,3 wins & 13 nominations.,0,3,13,16
Hot Rod,2 nominations,0,0,2,2
Into the Wild,Nominated for 2 Oscars. 23 wins & 106 nominations total,2,23,106,131
Mother of Tears,1 nomination.,0,0,1,1
Mr. Magorium's Wonder Emporium,3 nominations.,0,0,3,3
Hostel: Part II,10 nominations.,0,0,10,10
Mr. Woodcock,,0,0,0,0
Mi historia sin mi,,0,0,0,0
Stomp the Yard,9 nominations.,0,0,9,9
Are We Done Yet?,3 nominations.,0,0,3,3
Shrek the Third,Nominated for 1 BAFTA Film Award. Another 5 wins & 16 nominations.,0,5,17,22
The Invasion,1 win & 2 nominations,0,1,2,3
The Hunting Party,,0,0,0,0
Sex and Death 101,1 win.,0,1,0,1
American Gangster,Nominated for 2 Oscars. Another 12 wins & 36 nominations.,2,12,36,50
Disturbia,5 wins & 7 nominations,0,5,7,12
Shelter,11 wins.,0,11,0,11
Shoot 'Em Up,3 nominations.,0,0,3,3
Boy A,13 wins & 11 nominations.,0,13,11,24
Shooter,2 nominations.,0,0,2,2
We Own the Night,2 wins & 6 nominations.,0,2,6,8
Transformers,Nominated for 3 Oscars. 25 wins & 50 nominations total,3,25,50,78
A Mighty Heart,4 wins & 18 nominations,0,4,18,22
Diary of the Dead,1 win & 1 nomination.,0,1,1,2
The Hills Have Eyes II,,0,0,0,0
War,1 nomination,0,0,1,1
Bratz,5 nominations.,0,0,5,5
Descent,,0,0,0,0
Sleuth,Nominated for 4 Oscars. Another 5 wins & 7 nominations.,4,5,7,16
Breach,1 win & 3 nominations,0,1,3,4
Smiley Face,1 nomination.,0,0,1,1
The Invisible,1 nomination.,0,0,1,1
Saw IV,2 wins & 7 nominations,0,2,7,9
Snow Angels,1 win & 4 nominations.,0,1,4,5
Rogue,1 win & 4 nominations.,0,1,4,5
Reservation Road,1 win & 2 nominations.,0,1,2,3
Resident Evil: Extinction,2 wins & 2 nominations.,0,2,2,4
Retrato de amor,,0,0,0,0
El asesino de John Lennon,,0,0,0,0
The Last Mimzy,7 nominations.,0,0,7,7
Rewind,2 wins & 4 nominations,0,2,4,6
The Last Legion,2 nominations.,0,0,2,2
88 Minutes,3 nominations.,0,0,3,3
Rocket Science,2 wins & 7 nominations,0,2,7,9
Eastern Promises,Nominated for 1 Oscar. Another 28 wins & 73 nominations.,1,28,73,102
Eagle vs Shark,6 wins & 4 nominations,0,6,4,10
The Jane Austen Book Club,2 nominations.,0,0,2,2
Blades of Glory,3 wins & 10 nominations,0,3,10,13
Wind Chill,,0,0,0,0
"Run, Fatboy, Run",3 nominations.,0,0,3,3
The Kite Runner,Nominated for 1 Oscar. Another 6 wins & 24 nominations.,1,6,24,31
Rush Hour 3,9 nominations,0,0,9,9
Wild Hogs,1 win & 4 nominations.,0,1,4,5
Why Did I Get Married?,,0,0,0,0
Dragon Wars: D-War,,0,0,0,0
Blood and Chocolate,,0,0,0,0
The Heartbreak Kid,1 win.,0,1,0,1
Son of Rambow,3 wins & 10 nominations.,0,3,10,13
Reno 911!: Miami,,0,0,0,0
The Assassination of Jesse James by the Coward Robert Ford,Nominated for 2 Oscars. Another 26 wins & 68 nominations.,2,26,68,96
Talk to Me,8 wins & 14 nominations.,0,8,14,22
The Diving Bell and the Butterfly,,0,0,0,0
Cassandra's Dream,,0,0,0,0
Vacancy,1 win & 2 nominations,0,1,2,3
Teeth,2 wins & 10 nominations.,0,2,10,12
Un verano para toda la vida,,0,0,0,0
Across the Universe,Nominated for 1 Oscar. 2 wins & 18 nominations total,1,2,18,21
Control,Nominated for 1 BAFTA Film Award. Another 31 wins & 34 nominations.,0,31,35,66
The Air I Breathe,,0,0,0,0
The Darjeeling Limited,4 wins & 4 nominations,0,4,4,8
Charlie Bartlett,1 win,0,1,0,1
TMNT: Las Tortugas Ninja,,0,0,0,0
Charlie Wilson's War,Nominated for 1 Oscar. Another 5 wins & 22 nominations.,1,5,22,28
The Babysitters,,0,0,0,0
The Counterfeiters,,0,0,0,0
The Condemned,1 nomination.,0,0,1,1
The Bourne Ultimatum,Won 3 Oscars. 29 wins & 42 nominations total,3,29,42,74
The Brave One,Nominated for 1 Golden Globe. Another 1 win & 6 nominations.,0,1,7,8
The Comebacks,1 nomination.,0,0,1,1
Underdog,3 nominations,0,0,3,3
The Bucket List,3 wins & 4 nominations,0,3,4,7
Under the Same Moon,8 wins & 2 nominations.,0,8,2,10
Crimen sin perd�n,,0,0,0,0
Sydney White,,0,0,0,0
Bridge to Terabithia,6 wins & 5 nominations.,0,6,5,11
The Great Debaters,10 wins & 10 nominations,0,10,10,20
Alvin and the Chipmunks,3 wins & 2 nominations.,0,3,2,5
Death Sentence,3 nominations.,0,0,3,3
Spider-Man 3,Nominated for 1 BAFTA Film Award. Another 4 wins & 43 nominations.,0,4,44,48
Dead Silence,,0,0,0,0
Walk Hard: The Dewey Cox Story,1 win & 6 nominations.,0,1,6,7
Waitress,6 wins & 16 nominations.,0,6,16,22
Stardust,5 wins & 11 nominations.,0,5,11,16
The Golden Compass,Won 1 Oscar. Another 6 wins & 32 nominations.,1,6,32,39
Sweeney Todd: The Demon Barber of Fleet Street,Won 1 Oscar. Another 33 wins & 77 nominations.,1,33,77,111
The Game Plan,3 nominations.,0,0,3,3
Dan in Real Life,4 nominations,0,0,4,4
Daddy's Little Girls,1 nomination.,0,0,1,1
Sukiyaki Western Django,4 wins & 5 nominations,0,4,5,9
Superbad,11 wins & 24 nominations,0,11,24,35
Aliens vs. Predator: Requiem,5 nominations.,0,0,5,5
Captivity,1 win & 4 nominations.,0,1,4,5
Surf's Up,Nominated for 1 Oscar. Another 2 wins & 17 nominations.,1,2,17,20
The Kingdom,5 nominations.,0,0,5,5
Rendition,3 nominations,0,0,3,3
P2,1 nomination.,0,0,1,1
Balls of Fury,,0,0,0,0
The Savages,Nominated for 2 Oscars. 17 wins & 33 nominations total,2,17,33,52
2 Days in Paris,2 wins & 5 nominations,0,2,5,7
Paranormal Activity,3 wins & 12 nominations.,0,3,12,15
Pathfinder,1 nomination.,0,0,1,1
Reign Over Me,3 nominations.,0,0,3,3
Battle in Seattle,1 win & 4 nominations.,0,1,4,5
The Reaping,1 nomination,0,0,1,1
Perfect Stranger,1 nomination,0,0,1,1
Pers�polis,,0,0,0,0
Then She Found Me,3 wins & 1 nomination.,0,3,1,4
There Will Be Blood,Won 2 Oscars. Another 114 wins & 137 nominations.,2,114,137,253
Pirates of the Caribbean: At World's End,Nominated for 2 Oscars. 22 wins & 51 nominations total,2,22,51,75
Because I Said So,1 nomination.,0,0,1,1
Things We Lost in the Fire,3 wins & 2 nominations.,0,3,2,5
Fantastic 4: Rise of the Silver Surfer,3 wins & 17 nominations.,0,3,17,20
Becoming Jane,3 wins & 6 nominations,0,3,6,9
Bee Movie,1 win & 15 nominations,0,1,15,16
Postal,1 win & 3 nominations.,0,1,3,4
Before the Devil Knows You're Dead,17 wins & 27 nominations,0,17,27,44
P.S. I Love You,2 wins & 4 nominations.,0,2,4,6
Premonition,2 nominations.,0,0,2,2
The Seeker: The Dark Is Rising,,0,0,0,0
Music and Lyrics,6 nominations,0,0,6,6
The Visitor,Nominated for 1 Oscar. Another 19 wins & 34 nominations.,1,19,34,54
Georgia Rule,3 wins & 5 nominations,0,3,5,8
Nancy Drew,7 nominations.,0,0,7,7
Atonement,Won 1 Oscar. Another 50 wins & 149 nominations.,1,50,149,200
National Treasure: Book of Secrets,1 win & 5 nominations.,0,1,5,6
August Rush,Nominated for 1 Oscar. Another 4 wins & 10 nominations.,1,4,10,15
Funny Games,1 win & 6 nominations.,0,1,6,7
Next,2 wins & 3 nominations.,0,2,3,5
Awake,1 win & 3 nominations.,0,1,3,4
1408,4 wins & 12 nominations,0,4,12,16
No Country for Old Men,Won 4 Oscars. Another 159 wins & 140 nominations.,4,159,140,303
No Reservations,1 nomination.,0,0,1,1
Fred Claus,,0,0,0,0
Noches p�rpuras,,0,0,0,0
Norbit,Nominated for 1 Oscar. Another 8 wins & 8 nominations.,1,8,8,17
Fracture,1 win & 2 nominations.,0,1,2,3
Ocean's Thirteen,1 win & 5 nominations.,0,1,5,6
Zodiac,4 wins & 72 nominations.,0,4,72,76
Once,Won 1 Oscar. Another 23 wins & 32 nominations.,1,23,32,56
The Simpsons Movie,Nominated for 1 Golden Globe. Another 5 wins & 33 nominations.,0,5,34,39
This Christmas,4 nominations.,0,0,4,4
Feast of Love,,0,0,0,0
The Nines,2 nominations.,0,0,2,2
Redline,1 win & 3 nominations.,0,1,3,4
Towelhead,1 win & 3 nominations.,0,1,3,4
The Lookout,1 win & 11 nominations,0,1,11,12
3:10 to Yuma,Nominated for 2 Oscars. Another 3 wins & 30 nominations.,2,3,30,35
Enchanted,Nominated for 3 Oscars. 12 wins & 51 nominations total,3,12,51,66
Timber Falls,,0,0,0,0
30 Days of Night,14 nominations.,0,0,14,14
Escritores de la libertad,,0,0,0,0
Beowulf,3 wins & 19 nominations,0,3,19,22
Evan Almighty,2 wins & 11 nominations.,0,2,11,13
The Number 23,5 nominations.,0,0,5,5
The Mist,6 wins & 13 nominations,0,6,13,19
Evening,3 nominations.,0,0,3,3
28 Weeks Later,3 wins & 16 nominations.,0,3,16,19
Ratatouille,Won 1 Oscar. Another 66 wins & 42 nominations.,1,66,42,109
The Nanny Diaries,1 win & 2 nominations.,0,1,2,3
Youth Without Youth,1 win & 1 nomination,0,1,1,2
Epic Movie,2 wins & 3 nominations.,0,2,3,5
The Messengers,1 win & 2 nominations,0,1,2,3
The Orphanage,32 wins & 43 nominations.,0,32,43,75
Elizabeth: The Golden Age,Won 1 Oscar. Another 6 wins & 33 nominations.,1,6,33,40
The Marine,,0,0,0,0
Apocalypto,Nominated for 3 Oscars. Another 9 wins & 20 nominations.,3,9,20,32
Ultraviolet,1 win & 2 nominations.,0,1,2,3
The Wicker Man,2 wins & 6 nominations,0,2,6,8
Just My Luck,7 nominations.,0,0,7,7
John Tucker Must Die,2 wins & 2 nominations.,0,2,2,4
Cars,Nominated for 2 Oscars. Another 28 wins & 32 nominations.,2,28,32,62
Big Momma's House 2,1 win & 5 nominations.,0,1,5,6
Aquamarine,1 win & 5 nominations.,0,1,5,6
The Last Kiss,1 win & 4 nominations.,0,1,4,5
Casino Royale,Won 1 BAFTA Film Award. Another 26 wins & 44 nominations.,0,27,44,71
Babel,Won 1 Oscar. Another 42 wins & 136 nominations.,1,42,136,179
Ice Age: The Meltdown,8 wins & 16 nominations,0,8,16,24
Catch and Release,,0,0,0,0
Cashback,3 wins.,0,3,0,3
The Last King of Scotland,Won 1 Oscar. 49 wins & 32 nominations total,1,49,32,82
Lejos de ella,,0,0,0,0
Behind the Mask: The Rise of Leslie Vernon,5 wins & 3 nominations,0,5,3,8
The Devil Wears Prada,Nominated for 2 Oscars. Another 19 wins & 51 nominations.,2,19,51,72
Unaccompanied Minors,1 win & 3 nominations.,0,1,3,4
Black Book,Nominated for 1 BAFTA Film Award. Another 13 wins & 22 nominations.,0,13,23,36
Arthur and the Invisibles,,0,0,0,0
The Unknown Woman,21 wins & 26 nominations.,0,21,26,47
The Ultimate Gift,3 wins.,0,3,0,3
Black Christmas,2 wins & 2 nominations.,0,2,2,4
Idiocracy,1 nomination,0,0,1,1
The Covenant,,0,0,0,0
Charlotte's Web,10 wins & 11 nominations.,0,10,11,21
The Departed,Won 4 Oscars. 97 wins & 141 nominations total,4,97,141,242
The Lives of Others,Won 1 Oscar. Another 79 wins & 38 nominations.,1,79,38,118
The Da Vinci Code,8 wins & 21 nominations.,0,8,21,29
Black Snake Moan,1 win & 7 nominations,0,1,7,8
The Texas Chainsaw Massacre: The Beginning,6 nominations.,0,0,6,6
The Dead Girl,2 wins & 4 nominations.,0,2,4,6
Letters from Iwo Jima,Won 1 Oscar. Another 23 wins & 39 nominations.,1,23,39,63
Amores asesinos,,0,0,0,0
Let's Go to Prison,,0,0,0,0
Alex Rider: Operation Stormbreaker,,0,0,0,0
Candy,6 wins & 17 nominations,0,6,17,23
Last Holiday,7 nominations.,0,0,7,7
Hollywoodland,Nominated for 1 Golden Globe. Another 3 wins & 7 nominations.,0,3,8,11
The Queen,Won 1 Oscar. 96 wins & 97 nominations total,1,96,97,194
Breaking and Entering,6 nominations.,0,0,6,6
The Pursuit of Happyness,Nominated for 1 Oscar. Another 12 wins & 25 nominations.,1,12,25,38
La Granja,6 wins & 1 nomination.,0,6,1,7
Hombre lobo,,0,0,0,0
The Omen,Won 1 Oscar. Another 4 wins & 8 nominations.,1,4,8,13
The Hills Have Eyes,2 wins & 13 nominations,0,2,13,15
Bobby,6 wins & 25 nominations.,0,6,25,31
The History Boys,Nominated for 2 BAFTA Film Awards. Another 2 wins & 13 nominations.,0,2,15,17
Tristan + Isolde,,0,0,0,0
The Illusionist,Nominated for 1 Oscar. 11 wins & 12 nominations total,1,11,12,24
The Prestige,Nominated for 2 Oscars. 6 wins & 45 nominations total,2,6,45,53
Beerfest,1 win & 3 nominations.,0,1,3,4
The Pink Panther,1 win & 8 nominations.,0,1,8,9
Amazing Grace,3 wins & 6 nominations.,0,3,6,9
The Holiday,2 wins & 11 nominations,0,2,11,13
Borat: Cultural Learnings of America for Make Benefit Glorious Nation of Kazakhstan,Nominated for 1 Oscar. 20 wins & 34 nominations total,1,20,34,55
American Dreamz,1 nomination.,0,0,1,1
La Dalia Negra,,0,0,0,0
Lady in the Water,10 wins & 11 nominations,0,10,11,21
The Fall,4 wins & 11 nominations.,0,4,11,15
Annapolis,,0,0,0,0
The Fast and the Furious: Tokyo Drift,1 win & 4 nominations.,0,1,4,5
All the King's Men,2 wins & 4 nominations,0,2,4,6
The Sentinel,2 nominations,0,0,2,2
The Foot Fist Way,1 win.,0,1,0,1
Turistas,1 win & 1 nomination,0,1,1,2
The Lake House,2 wins & 2 nominations,0,2,2,4
Blind Dating,,0,0,0,0
The Fountain,9 wins & 39 nominations,0,9,39,48
The Good German,Nominated for 1 Oscar. Another 3 wins & 4 nominations.,1,3,4,8
Bug,1 win & 6 nominations,0,1,6,7
The Good Shepherd,Nominated for 1 Oscar. 2 wins & 13 nominations total,1,2,13,16
The Namesake,5 wins & 6 nominations.,0,5,6,11
The Science of Sleep,,0,0,0,0
The Santa Clause 3: The Escape Clause,4 wins & 9 nominations.,0,4,9,13
Basic Instinct 2,8 wins & 6 nominations,0,8,6,14
Al otro lado del mundo,,0,0,0,0
The Grudge 2,3 nominations.,0,0,3,3
Children of Men,Nominated for 3 Oscars. Another 49 wins & 86 nominations.,3,49,86,138
Inside Man,5 wins & 12 nominations.,0,5,12,17
Akeelah and the Bee,11 wins & 15 nominations.,0,11,15,26
X-Men III: La batalla final,,0,0,0,0
Mi mascota es un zombie,,0,0,0,0
Employee of the Month,2 nominations.,0,0,2,2
Miami Vice,1 win & 9 nominations,0,1,9,10
Grandma's Boy,1 nomination.,0,0,1,1
300,19 wins & 55 nominations.,0,19,55,74
Goya's Ghosts,2 wins & 5 nominations.,0,2,5,7
Eragon,1 win & 6 nominations,0,1,6,7
RV,1 win & 2 nominations,0,1,2,3
"You, Me and Dupree",3 wins & 2 nominations.,0,3,2,5
Everyone's Hero,,0,0,0,0
Priceless,1 win & 1 nomination.,0,1,1,2
Rescue Dawn,1 win & 6 nominations.,0,1,6,7
El imperio,,0,0,0,0
Gridiron Gang,,0,0,0,0
Scoop,2 nominations,0,0,2,2
Half Nelson,Nominated for 1 Oscar. Another 29 wins & 47 nominations.,1,29,47,77
School for Scoundrels,2 nominations.,0,0,2,2
Scary Movie 4,1 win & 3 nominations,0,1,3,4
Saw III,1 win & 9 nominations.,0,1,9,10
The Break-Up,3 wins & 5 nominations,0,3,5,8
Running with Scissors,3 wins & 7 nominations.,0,3,7,10
World Trade Center,4 wins & 12 nominations.,0,4,12,16
Rocky Balboa,4 nominations,0,0,4,4
Eight Below,2 wins & 2 nominations.,0,2,2,4
Wristcutters: A Love Story,9 wins & 6 nominations.,0,9,6,15
El Perfume: Historia de un asesino,,0,0,0,0
Infamous,3 wins & 2 nominations.,0,3,2,5
Poseidon,Nominated for 1 Oscar. Another 6 nominations.,1,0,6,7
Seraphim Falls,1 win & 1 nomination,0,1,1,2
Flags of our Fathers,Nominated for 2 Oscars. 16 wins & 28 nominations total,2,16,28,46
Over the Hedge,7 wins & 26 nominations.,0,7,26,33
Flicka,3 nominations.,0,0,3,3
Open Season,1 win & 10 nominations,0,1,10,11
One Night with the King,2 wins.,0,2,0,2
Flushed Away,Nominated for 1 BAFTA Film Award. Another 7 wins & 14 nominations.,0,7,15,22
Flyboys,2 wins & 3 nominations.,0,2,3,5
Notes on a Scandal,Nominated for 4 Oscars. Another 15 wins & 70 nominations.,4,15,70,89
16 Blocks,2 nominations.,0,0,2,2
Night at the Museum,2 wins & 8 nominations.,0,2,8,10
Friends with Money,2 wins & 2 nominations.,0,2,2,4
Fur: An Imaginary Portrait of Diane Arbus,2 wins.,0,2,0,2
Zoom,4 wins & 8 nominations.,0,4,8,12
Nacho Libre,1 win & 11 nominations,0,1,11,12
My Super Ex-Girlfriend,1 win & 1 nomination.,0,1,1,2
Garfield 2,,0,0,0,0
Glory Road,2 wins & 3 nominations.,0,2,3,5
Monster House,Nominated for 1 Oscar. Another 4 wins & 22 nominations.,1,4,22,27
Facing the Giants,,0,0,0,0
Pan's Labyrinth,,0,0,0,0
Miss Potter,Nominated for 1 Golden Globe. Another 5 wins & 4 nominations.,0,5,5,10
Factory Girl,1 nomination,0,0,1,1
Failure to Launch,5 nominations,0,0,5,5
Pisando firme,,0,0,0,0
Pirates of the Caribbean: Dead Man's Chest,Won 1 Oscar. 45 wins & 54 nominations total,1,45,54,100
Fast Food Nation,1 win & 3 nominations.,0,1,3,4
Mission: Impossible III,7 wins & 14 nominations.,0,7,14,21
Penelope,,0,0,0,0
Peaceful Warrior,,0,0,0,0
"Paris, je t'aime",3 wins & 2 nominations.,0,3,2,5
Find Me Guilty,1 win & 2 nominations.,0,1,2,3
Paprika,,0,0,0,0
Firewall,3 nominations.,0,0,3,3
See No Evil,3 nominations,0,0,3,3
Dreamgirls,Won 2 Oscars. 67 wins & 92 nominations total,2,67,92,161
A Good Year,1 win & 2 nominations.,0,1,2,3
Volver,Nominated for 1 Oscar. Another 61 wins & 93 nominations.,1,61,93,155
Talladega Nights: The Ballad of Ricky Bobby,8 wins & 9 nominations.,0,8,9,17
Criaturas rastreras,,0,0,0,0
Take the Lead,1 win & 6 nominations,0,1,6,7
Van Wilder 2: The Rise of Taj,1 nomination.,0,0,1,1
Superman Returns,Nominated for 1 Oscar. Another 12 wins & 46 nominations.,1,12,46,59
ATL,7 nominations.,0,0,7,7
Cuentos de Terramar,,0,0,0,0
Lucky Number Slevin,5 wins & 4 nominations.,0,5,4,9
Curious George,1 nomination.,0,0,1,1
Curse of the Golden Flower,Nominated for 1 Oscar. Another 20 wins & 33 nominations.,1,20,33,54
Hatchet,6 wins & 1 nomination.,0,6,1,7
DOA: Dead or Alive,1 nomination,0,0,1,1
Stranger Than Fiction,3 wins & 15 nominations,0,3,15,18
Step Up,1 win & 3 nominations,0,1,3,4
Crank,2 wins & 2 nominations.,0,2,2,4
Accepted,4 nominations.,0,0,4,4
United 93,Nominated for 2 Oscars. Another 29 wins & 55 nominations.,2,29,55,86
Clerks II,3 wins & 3 nominations,0,3,3,6
Click,Nominated for 1 Oscar. 3 wins & 12 nominations total,1,3,12,16
Little Children,Nominated for 3 Oscars. Another 20 wins & 58 nominations.,3,20,58,81
The Benchwarmers,7 nominations.,0,0,7,7
Underworld: Evolution,2 wins & 6 nominations.,0,2,6,8
Little Miss Sunshine,Won 2 Oscars. Another 70 wins & 112 nominations.,2,70,112,184
The Astronaut Farmer,,0,0,0,0
Littleman,,0,0,0,0
The Ant Bully,1 win & 4 nominations.,0,1,4,5
Terror en Silent Hill,,0,0,0,0
Tenacious D in The Pick of Destiny,2 nominations.,0,0,2,2
Date Movie,4 wins & 1 nomination,0,4,1,5
Vida salvaje,,0,0,0,0
Stay Alive,,0,0,0,0
Man of the Year,1 nomination.,0,0,1,1
Something New,4 wins & 10 nominations.,0,4,10,14
Deja Vu,1 win & 6 nominations,0,1,6,7
Smokin' Aces,4 wins.,0,4,0,4
Happy Feet,Won 1 Oscar. Another 19 wins & 26 nominations.,1,19,26,46
Destino final 3,,0,0,0,0
We Are Marshall,1 nomination.,0,0,1,1
Diamante de sangre,,0,0,0,0
Deck the Halls,1 win & 8 nominations,0,1,8,9
When a Stranger Calls,3 nominations,0,0,3,3
She's the Man,2 wins & 5 nominations.,0,2,5,7
Marie Antoinette,Won 1 Oscar. Another 18 wins & 23 nominations.,1,18,23,42
Severance,3 wins & 2 nominations.,0,3,2,5
A Guide to Recognizing Your Saints,8 wins & 9 nominations.,0,8,9,17
Serpientes a bordo,,0,0,0,0
A Scanner Darkly,4 wins & 21 nominations,0,4,21,25
Despu�s de la boda,,0,0,0,0
Starter for 10,1 win & 3 nominations.,0,1,3,4
Madea's Family Reunion,7 nominations.,0,0,7,7
Sospechas mortales,,0,0,0,0
Southland Tales,1 win & 3 nominations.,0,1,3,4
Two for the Money,2 nominations.,0,0,2,2
Junebug,Nominated for 1 Oscar. Another 21 wins & 27 nominations.,1,21,27,49
The White Countess,2 nominations.,0,0,2,2
"Yours, Mine & Ours",2 wins & 4 nominations.,0,2,4,6
Thumbsucker,5 wins & 5 nominations,0,5,5,10
White Noise,1 win & 2 nominations,0,1,2,3
Jarhead,6 wins & 12 nominations.,0,6,12,18
Three Burials,5 wins & 9 nominations.,0,5,9,14
Tideland,1 win & 12 nominations.,0,1,12,13
Tsotsi,Won 1 Oscar. Another 22 wins & 18 nominations.,1,22,18,41
Waiting...,,0,0,0,0
The Wedding Date,,0,0,0,0
Into the Blue,1 win & 2 nominations.,0,1,2,3
xXx: State of the Union,1 nomination,0,0,1,1
Wedding Crashers,11 wins & 11 nominations.,0,11,11,22
Unleashed,1 nomination,0,0,1,1
Winter Passing,,0,0,0,0
The Weather Man,,0,0,0,0
V for Vendetta,7 wins & 29 nominations,0,7,29,36
Wolf Creek,3 wins & 26 nominations.,0,3,26,29
Transporter 2,,0,0,0,0
Zathura: A Space Adventure,2 wins & 3 nominations,0,2,3,5
War of the Worlds,Nominated for 3 Oscars. Another 16 wins & 46 nominations.,3,16,46,65
The World's Fastest Indian,11 wins & 6 nominations.,0,11,6,17
Joyeux Noel,Nominated for 1 Oscar. Another 6 wins & 11 nominations.,1,6,11,18
Valiant,2 nominations.,0,0,2,2
Tierra de los muertos,,0,0,0,0
Transamerica,Nominated for 2 Oscars. Another 32 wins & 24 nominations.,2,32,24,58
The Zodiac,,0,0,0,0
Walk the Line,Won 1 Oscar. Another 43 wins & 48 nominations.,1,43,48,92
Venom,3 wins & 9 nominations.,0,3,9,12
Mrs Henderson Presents,,0,0,0,0
The Upside of Anger,5 wins & 13 nominations.,0,5,13,18
Just Friends,3 nominations.,0,0,3,3
Match Point,Nominated for 1 Oscar. 12 wins & 32 nominations total,1,12,32,45
Serenity,9 wins & 10 nominations,0,9,10,19
Marilyn Hotchkiss' Ballroom Dancing & Charm School,1 nomination.,0,0,1,1
Shadowboxer,1 win & 2 nominations.,0,1,2,3
Shopgirl,1 win & 7 nominations.,0,1,7,8
Man-Thing,,0,0,0,0
Si te casas... te mato,,0,0,0,0
Sin City,38 wins & 54 nominations.,0,38,54,92
Sky High,1 nomination.,0,0,1,1
Son of the Mask,7 wins & 12 nominations.,0,7,12,19
Star Wars: Episode III - Revenge of the Sith,Nominated for 1 Oscar. Another 26 wins & 62 nominations.,1,26,62,89
Madagascar,4 wins & 32 nominations.,0,4,32,36
Stay,1 nomination.,0,0,1,1
Stealth,2 nominations.,0,0,2,2
Strangers with Candy,,0,0,0,0
Lovewrecked,,0,0,0,0
Supercross,,0,0,0,0
Syriana,Won 1 Oscar. Another 12 wins & 30 nominations.,1,12,30,43
Tamara,1 nomination.,0,0,1,1
Lords of Dogtown,1 win & 7 nominations,0,1,7,8
Lord of War,2 wins & 3 nominations,0,2,3,5
Saw II,4 wins & 11 nominations,0,4,11,15
Sahara,2 wins & 5 nominations,0,2,5,7
Must Love Dogs,1 nomination.,0,0,1,1
Nanny McPhee,3 wins & 4 nominations.,0,3,4,7
Mr. & Mrs. Smith,9 wins & 18 nominations.,0,9,18,27
North Country,Nominated for 2 Oscars. Another 5 wins & 18 nominations.,2,5,18,25
Oliver Twist,2 wins & 4 nominations,0,2,4,6
Paradise Now,Nominated for 1 Oscar. Another 13 wins & 16 nominations.,1,13,16,30
Miss Congeniality 2: Armed and Fabulous,,0,0,0,0
Pretty Persuasion,1 win & 2 nominations.,0,1,2,3
Pride & Prejudice,Won 1 BAFTA Film Award. Another 9 wins & 23 nominations.,0,10,23,33
Prime,1 nomination,0,0,1,1
Mirrormask,5 wins & 2 nominations,0,5,2,7
Rumor Has It...,,0,0,0,0
Racing Stripes,3 nominations.,0,0,3,3
Rebound,2 nominations.,0,0,2,2
Red Eye,2 wins & 9 nominations.,0,2,9,11
Regresiones de un hombre muerto,,0,0,0,0
Rent,1 win & 21 nominations,0,1,21,22
Memoirs of a Geisha,Won 3 Oscars. Another 29 wins & 47 nominations.,3,29,47,79
Revolver,1 win,0,1,0,1
Robots,2 wins & 22 nominations.,0,2,22,24
Me and You and Everyone We Know,22 wins & 15 nominations,0,22,15,37
Roll Bounce,2 wins & 6 nominations.,0,2,6,8
Romance & Cigarettes,1 nomination.,0,0,1,1
London,1 win & 1 nomination.,0,1,1,2
Thank You for Smoking,12 wins & 32 nominations,0,12,32,44
The 40-Year-Old Virgin,10 wins & 19 nominations,0,10,19,29
The Perfect Man,2 wins & 3 nominations.,0,2,3,5
The Legend of Zorro,2 wins & 3 nominations.,0,2,3,5
The Longest Yard,3 wins & 17 nominations,0,3,17,20
The Man,1 win & 1 nomination.,0,1,1,2
The Matador,1 win & 6 nominations,0,1,6,7
The New World,Nominated for 1 Oscar. Another 6 wins & 33 nominations.,1,6,33,40
The Notorious Bettie Page,4 nominations,0,0,4,4
Kiss Kiss Bang Bang,5 wins & 16 nominations.,0,5,16,21
Kinky Boots,1 win & 7 nominations.,0,1,7,8
The Pacifier,1 win & 10 nominations.,0,1,10,11
Kingdom of Heaven,5 wins & 15 nominations.,0,5,15,20
King Kong,Won 3 Oscars. Another 43 wins & 104 nominations.,3,43,104,150
The Producers,Won 1 Oscar. Another 2 wins & 5 nominations.,1,2,5,8
The Island,1 win & 6 nominations.,0,1,6,7
The Quiet,1 win.,0,1,0,1
The Ring Two,2 wins & 11 nominations.,0,2,11,13
The Ringer,1 nomination,0,0,1,1
Kicking & Screaming,6 nominations,0,0,6,6
Keeping Mum,1 win & 5 nominations,0,1,5,6
The Sisterhood of the Traveling Pants,1 win & 14 nominations.,0,1,14,15
The Skeleton Key,5 nominations,0,0,5,5
Just Like Heaven,1 win & 1 nomination,0,1,1,2
The Squid and the Whale,Nominated for 1 Oscar. 23 wins & 49 nominations total,1,23,49,73
L'enfant,3 nominations,0,0,3,3
The Interpreter,3 wins & 2 nominations,0,3,2,5
The Adventures of Sharkboy and Lavagirl 3-D,1 win & 10 nominations,0,1,10,11
The Descent,8 wins & 22 nominations,0,8,22,30
The Amityville Horror,2 wins & 4 nominations.,0,2,4,6
Little Manhattan,,0,0,0,0
The Ballad of Jack and Rose,3 wins & 6 nominations.,0,3,6,9
The Brothers Grimm,4 wins & 5 nominations.,0,4,5,9
The Cave,,0,0,0,0
"The Chronicles of Narnia: The Lion, the Witch and the Wardrobe",Won 1 Oscar. Another 17 wins & 46 nominations.,1,17,46,64
The Chumscrubber,1 nomination.,0,0,1,1
The Constant Gardener,Won 1 Oscar. 35 wins & 69 nominations total,1,35,69,105
Munich,Nominated for 5 Oscars. Another 14 wins & 70 nominations.,5,14,70,89
The Death of Mr. Lazarescu,30 wins & 14 nominations.,0,30,14,44
The Devil's Rejects,10 wins & 8 nominations.,0,10,8,18
La casa de cera,,0,0,0,0
The Dukes of Hazzard,5 wins & 14 nominations,0,5,14,19
The Exorcism of Emily Rose,4 wins & 9 nominations.,0,4,9,13
The Family Stone,4 wins & 8 nominations,0,4,8,12
The Fog,1 win & 2 nominations.,0,1,2,3
Last Days,3 wins & 5 nominations.,0,3,5,8
The Great Raid,1 nomination.,0,0,1,1
The Greatest Game Ever Played,3 nominations.,0,0,3,3
Lady Vengeance,12 wins & 13 nominations.,0,12,13,25
The Hitchhiker's Guide to the Galaxy,1 win & 10 nominations,0,1,10,11
La mujer de mi hermano,,0,0,0,0
La marca de la bestia,,0,0,0,0
The Curse of the Were-Rabbit,Won 1 Oscar. Another 39 wins & 25 nominations.,1,39,25,65
�on Flux,,0,0,0,0
Dark Water,6 nominations.,0,0,6,6
Imagine Me & You,,0,0,0,0
Harry Potter and the Goblet of Fire,Nominated for 1 Oscar. Another 13 wins & 43 nominations.,1,13,43,57
Alone in the Dark,4 wins & 3 nominations.,0,4,3,7
Cry_Wolf,,0,0,0,0
Capote,Won 1 Oscar. Another 58 wins & 89 nominations.,1,58,89,148
Bewitched,2 wins & 13 nominations.,0,2,13,15
Harsh Times,2 nominations.,0,0,2,2
Casanova,5 wins & 3 nominations.,0,5,3,8
Dirty Deeds,,0,0,0,0
Herbie Fully Loaded,2 wins & 6 nominations.,0,2,6,8
Get Rich or Die Tryin',6 wins & 3 nominations.,0,6,3,9
Feast,1 win.,0,1,0,1
Dirty Love,4 wins & 7 nominations.,0,4,7,11
Bad News Bears,1 win & 4 nominations.,0,1,4,5
Goal! The Dream Begins,1 win & 6 nominations.,0,1,6,7
Hostel,6 wins & 14 nominations.,0,6,14,20
Angel-A,,0,0,0,0
Guess Who,16 nominations,0,0,16,16
Hostage,4 nominations.,0,0,4,4
Diary of a Mad Black Woman,13 wins & 13 nominations.,0,13,13,26
In Her Shoes,1 win & 7 nominations,0,1,7,8
Ice Princess,,0,0,0,0
Brokeback Mountain,Won 3 Oscars. Another 138 wins & 132 nominations.,3,138,132,273
Brick,11 wins & 23 nominations.,0,11,23,34
Broken Flowers,5 wins & 14 nominations.,0,5,14,19
Breakfast on Pluto,6 wins & 17 nominations.,0,6,17,23
Elizabethtown,2 wins & 4 nominations.,0,2,4,6
Beowulf & Grendel,3 wins & 19 nominations,0,3,19,22
Derailed,,0,0,0,0
Because of Winn-Dixie,2 nominations.,0,0,2,2
Beauty Shop,15 nominations,0,0,15,15
Everything Is Illuminated,7 wins & 6 nominations,0,7,6,13
Elektra,2 nominations.,0,0,2,2
Be Cool,1 win & 13 nominations.,0,1,13,14
Deuce Bigalow: European Gigolo,3 wins & 10 nominations.,0,3,10,13
Boogeyman,,0,0,0,0
Cach�,,0,0,0,0
Batman Begins,Nominated for 1 Oscar. 13 wins & 79 nominations total,1,13,79,93
Hard Candy,10 wins & 13 nominations,0,10,13,23
An Unfinished Life,3 wins & 1 nomination,0,3,1,4
A History of Violence,Nominated for 2 Oscars. 37 wins & 84 nominations total,2,37,84,123
Fun with Dick and Jane,1 win & 7 nominations.,0,1,7,8
Doom,3 nominations.,0,0,3,3
Green Street Hooligans,,0,0,0,0
Are We There Yet?,1 win & 8 nominations.,0,1,8,9
Dominion: Prequel to the Exorcist,,0,0,0,0
Hitch,4 wins & 24 nominations,0,4,24,28
Chicken Little,4 wins & 15 nominations.,0,4,15,19
Hide and Seek,1 win & 5 nominations.,0,1,5,6
Assault on Precinct 13,1 win & 2 nominations.,0,1,2,3
Cheaper by the Dozen 2,1 win & 5 nominations.,0,1,5,6
Flightplan,2 wins & 6 nominations,0,2,6,8
A Lot Like Love,1 win & 3 nominations.,0,1,3,4
"Good Night, and Good Luck.",Nominated for 6 Oscars. 38 wins & 129 nominations total,6,38,129,173
Cinderella Man,Nominated for 3 Oscars. Another 16 wins & 42 nominations.,3,16,42,61
Dreamer: Inspired by a True Story,,0,0,0,0
Hoodwinked!,1 nomination,0,0,1,1
BloodRayne,4 wins & 11 nominations,0,4,11,15
Four Brothers,5 wins & 9 nominations,0,5,9,14
Coach Carter,3 wins & 15 nominations,0,3,15,18
Constantine,2 wins & 10 nominations,0,2,10,12
An American Haunting,5 nominations.,0,0,5,5
Corpse Bride,Nominated for 1 Oscar. 9 wins & 30 nominations total,1,9,30,40
A Sound of Thunder,4 nominations,0,0,4,4
Charlie and the Chocolate Factory,Nominated for 1 Oscar. 15 wins & 52 nominations total,1,15,52,68
Adam's Apples,20 wins & 13 nominations.,0,20,13,33
Asylum,2 wins.,0,2,0,2
Domino,2 wins.,0,2,0,2
Million Dollar Baby,Won 4 Oscars. 67 wins & 86 nominations total,4,67,86,157
The Notebook,12 wins & 10 nominations.,0,12,10,22
Kill Bill: Vol. 2,23 wins & 84 nominations.,0,23,84,107
Godsend,,0,0,0,0
The Life Aquatic with Steve Zissou,3 wins & 10 nominations,0,3,10,13
Ella Enchanted,1 nomination.,0,0,1,1
Enduring Love,4 wins & 12 nominations.,0,4,12,16
The Libertine,2 wins & 8 nominations.,0,2,8,10
Ray,Won 2 Oscars. Another 51 wins & 54 nominations.,2,51,54,107
Raising Helen,1 nomination.,0,0,1,1
Saved!,1 win & 6 nominations,0,1,6,7
Raise Your Voice,2 wins & 3 nominations.,0,2,3,5
The Passion of the Christ,Nominated for 3 Oscars. Another 29 wins & 21 nominations.,3,29,21,53
Hellboy,3 wins & 23 nominations.,0,3,23,26
El aviador,,0,0,0,0
Resident Evil: Apocalypse,6 wins & 3 nominations.,0,6,3,9
The Motorcycle Diaries,Won 1 Oscar. Another 35 wins & 49 nominations.,1,35,49,85
Beyond the Sea,Nominated for 1 Golden Globe. Another 6 nominations.,0,0,7,7
Rory O'Shea Was Here,5 wins & 8 nominations.,0,5,8,13
A Cinderella Story,6 wins & 8 nominations,0,6,8,14
Torque,4 nominations.,0,0,4,4
We Don't Live Here Anymore,2 wins & 4 nominations,0,2,4,6
The Machinist,7 wins & 15 nominations,0,7,15,22
The Merchant of Venice,2 wins & 7 nominations total,0,2,7,9
Win a Date with Tad Hamilton!,8 nominations.,0,0,8,8
Wimbledon,1 nomination.,0,0,1,1
Howl's Moving Castle,Nominated for 1 Oscar. Another 14 wins & 19 nominations.,1,14,19,34
Riding the Bullet,1 nomination.,0,0,1,1
Layer Cake,2 wins & 9 nominations.,0,2,9,11
Birth,Nominated for 1 Golden Globe. Another 2 wins & 17 nominations.,0,2,18,20
The Manchurian Candidate,Nominated for 1 BAFTA Film Award. Another 1 win & 11 nominations.,0,1,12,13
Miracle,2 wins & 4 nominations.,0,2,4,6
Saint Ralph,6 wins & 9 nominations.,0,6,9,15
Millions,2 wins & 7 nominations.,0,2,7,9
Envy,3 nominations,0,0,3,3
Modigliani,2 nominations.,0,0,2,2
The Perfect Score,1 nomination.,0,0,1,1
Bad Education,Nominated for 1 BAFTA Film Award. Another 16 wins & 41 nominations.,0,16,42,58
Finding Neverland,Won 1 Oscar. Another 18 wins & 81 nominations.,1,18,81,100
First Daughter,,0,0,0,0
A Home at the End of the World,1 win & 5 nominations.,0,1,5,6
A Love Song for Bobby Long,Nominated for 1 Golden Globe. Another 3 nominations.,0,0,4,4
P.S.,3 wins & 4 nominations.,0,3,4,7
The SpongeBob SquarePants Movie,1 win & 10 nominations.,0,1,10,11
Las leyes de atracci�n,,0,0,0,0
My Summer of Love,9 wins & 20 nominations.,0,9,20,29
The Stepford Wives,3 wins.,0,3,0,3
Flight of the Phoenix,2 nominations.,0,0,2,2
Garfield,1 win & 1 nomination.,0,1,1,2
La isla maldita,,0,0,0,0
Garden State,13 wins & 39 nominations,0,13,39,52
Before Sunset,Nominated for 1 Oscar. 9 wins & 32 nominations total,1,9,32,42
The Terminal,7 wins & 8 nominations.,0,7,8,15
Napoleon Dynamite,10 wins & 23 nominations.,0,10,23,33
Home on the Range,5 nominations.,0,0,5,5
Ocean's Twelve,4 wins & 10 nominations,0,4,10,14
The Woodsman,7 wins & 20 nominations,0,7,20,27
National Treasure,1 win & 9 nominations.,0,1,9,10
The Village,Nominated for 1 Oscar. Another 4 wins & 23 nominations.,1,4,23,28
Around the World in 80 Days,2 wins & 2 nominations,0,2,2,4
Ladder 49,1 win & 7 nominations.,0,1,7,8
Ladies in Lavender,3 nominations.,0,0,3,3
Night Watch,2 wins & 10 nominations.,0,2,10,12
The Whole Ten Yards,1 win & 1 nomination.,0,1,1,2
New York Minute,6 nominations,0,0,6,6
Highwaymen,2 nominations.,0,0,2,2
Kung Fu Hustle,Nominated for 1 BAFTA Film Award. Another 25 wins & 46 nominations.,0,25,47,72
Anchorman: The Legend of Ron Burgundy,1 win & 13 nominations.,0,1,13,14
The Sea Inside,Won 1 Oscar. Another 67 wins & 38 nominations.,1,67,38,106
King Arthur,4 wins & 8 nominations,0,4,8,12
Wicker Park,1 nomination,0,0,1,1
Eros,1 win & 1 nomination,0,1,1,2
A Dirty Shame,1 win.,0,1,0,1
Eternal Sunshine of the Spotless Mind,Won 1 Oscar. 73 wins & 111 nominations total,1,73,111,185
The Polar Express,Nominated for 3 Oscars. Another 5 wins & 23 nominations.,3,5,23,31
Eulogy,,0,0,0,0
EuroTrip,2 nominations.,0,0,2,2
The Prince and Me,,0,0,0,0
The Princess Diaries 2: Royal Engagement,1 win & 2 nominations.,0,1,2,3
Kinsey,Nominated for 1 Oscar. Another 17 wins & 50 nominations.,1,17,50,68
Primer,3 wins & 7 nominations.,0,3,7,10
Exorcist: The Beginning,6 nominations,0,0,6,6
Saw,8 wins & 10 nominations,0,8,10,18
House of Flying Daggers,Nominated for 1 Oscar. Another 26 wins & 73 nominations.,1,26,73,100
House of D,,0,0,0,0
Mr 3000,1 win & 5 nominations,0,1,5,6
Welcome to Mooseport,,0,0,0,0
Anacondas: The Hunt for the Blood Orchid,2 nominations.,0,0,2,2
Ghost in the Shell 2: Innocence,6 wins & 8 nominations.,0,6,8,14
White Chicks,3 wins & 13 nominations.,0,3,13,16
Fat Albert,1 nomination.,0,0,1,1
Thunderbirds,1 win & 1 nomination,0,1,1,2
Hotel Rwanda,Nominated for 3 Oscars. 16 wins & 49 nominations total,3,16,49,68
Three... Extremes,5 wins & 14 nominations.,0,5,14,19
Barbershop 2: Back in Business,2 wins & 10 nominations.,0,2,10,12
A Good Woman,3 nominations,0,0,3,3
Saving Face,3 wins & 3 nominations.,0,3,3,6
Secret Window,3 nominations,0,0,3,3
Steamboy,3 wins.,0,3,0,3
Starsky & Hutch,3 wins & 10 nominations,0,3,10,13
D.E.B.S.,1 win & 2 nominations.,0,1,2,3
Harold & Kumar Go to White Castle,,0,0,0,0
Undertow,3 wins & 6 nominations.,0,3,6,9
The Final Cut,1 win & 4 nominations,0,1,4,5
You Got Served,1 win & 5 nominations.,0,1,5,6
Van Helsing,3 wins & 21 nominations.,0,3,21,24
The Forgotten,7 nominations.,0,0,7,7
13 Going on 30,11 nominations.,0,0,11,11
AVP: Alien vs. Predator,,0,0,0,0
Dawn of the Dead,1 win & 17 nominations.,0,1,17,18
The Girl Next Door,2 wins & 4 nominations.,0,2,4,6
3-Iron,16 wins & 11 nominations.,0,16,11,27
Superbabies: Baby Geniuses 2,13 nominations.,0,0,13,13
De-Lovely,Nominated for 2 Golden Globes. Another 2 wins & 11 nominations.,0,2,13,15
Alexander,6 wins & 19 nominations.,0,6,19,25
Walking Tall,2 nominations,0,0,2,2
Stage Beauty,4 wins & 1 nomination.,0,4,1,5
Alfie,Won 1 Golden Globe. Another 6 wins & 8 nominations.,0,7,8,15
Two Brothers,,0,0,0,0
Spider-Man 2,Won 1 Oscar. Another 24 wins & 60 nominations.,1,24,60,85
Dear Frankie,8 wins & 8 nominations.,0,8,8,16
Spanglish,5 wins & 15 nominations.,0,5,15,20
Summer Storm,4 wins & 4 nominations.,0,4,4,8
Collateral,Nominated for 2 Oscars. Another 22 wins & 71 nominations.,2,22,71,95
The Grudge,2 wins & 10 nominations.,0,2,10,12
After the Sunset,1 nomination.,0,0,1,1
Chasing Liberty,5 nominations.,0,0,5,5
Head in the Clouds,7 wins & 5 nominations.,0,7,5,12
Connie and Carla,1 win,0,1,0,1
Lila Says,,0,0,0,0
Team America: World Police,1 win & 11 nominations.,0,1,11,12
2046,38 wins & 81 nominations.,0,38,81,119
Ma m�re,,0,0,0,0
In Good Company,2 wins & 8 nominations.,0,2,8,10
The Alamo,1 nomination.,0,0,1,1
The Day After Tomorrow,Won 1 BAFTA Film Award. Another 5 wins & 12 nominations.,0,6,12,18
Crash,Won 3 Oscars. Another 63 wins & 112 nominations.,3,63,112,178
Harry Potter and the Prisoner of Azkaban,Nominated for 2 Oscars. Another 17 wins & 51 nominations.,2,17,51,70
Cellular,2 nominations.,0,0,2,2
Yu-Gi-Oh!: The Movie,,0,0,0,0
Taking Lives,4 nominations,0,0,4,4
Catwoman,13 wins & 8 nominations,0,13,8,21
It's All Gone Pete Tong,11 wins & 9 nominations.,0,11,9,20
Catch That Kid,1 nomination.,0,0,1,1
The Clearing,1 nomination,0,0,1,1
The Door in the Floor,2 wins & 7 nominations.,0,2,7,9
Agent Cody Banks 2: Destination London,,0,0,0,0
Suspect Zero,,0,0,0,0
Surviving Christmas,2 wins & 5 nominations.,0,2,5,7
Jersey Girl,2 wins & 8 nominations,0,2,8,10
Spartan,,0,0,0,0
A Series of Unfortunate Events,Won 1 Oscar. 10 wins & 28 nominations total,1,10,28,39
Meet the Fockers,2 wins & 7 nominations,0,2,7,9
Shaun of the Dead,13 wins & 20 nominations.,0,13,20,33
Vera Drake,Nominated for 3 Oscars. Another 41 wins & 42 nominations.,3,41,42,86
Mean Creek,4 wins & 6 nominations,0,4,6,10
Christmas with the Kranks,3 wins & 4 nominations.,0,3,4,7
Shark Tale,Nominated for 1 Oscar. Another 3 wins & 15 nominations.,1,3,15,19
District B13,1 win & 1 nomination.,0,1,1,2
Hidalgo,1 win & 2 nominations.,0,1,2,3
Shall We Dance,7 nominations.,0,0,7,7
Mean Girls,7 wins & 25 nominations.,0,7,25,32
Troy,Nominated for 1 Oscar. Another 5 wins & 22 nominations.,1,5,22,28
Dodgeball: A True Underdog Story,2 wins & 9 nominations.,0,2,9,11
Juego de viernes por la noche,,0,0,0,0
Chucky 5: El Hijo de Chucky,,0,0,0,0
The Butterfly Effect,1 win & 8 nominations.,0,1,8,9
Dirty Dancing: Havana Nights,1 nomination,0,0,1,1
"Julia, una mujer seductora",,0,0,0,0
The Ladykillers,6 wins & 4 nominations.,0,6,4,10
The Big Bounce,,0,0,0,0
I Heart Huckabees,3 wins & 11 nominations.,0,3,11,14
Melinda and Melinda,,0,0,0,0
A Very Long Engagement,2 wins & 1 nomination.,0,2,1,3
Scooby-Doo 2: Monsters Unleashed,1 win & 4 nominations.,0,1,4,5
Without a Paddle,,0,0,0,0
Blade: Trinity,1 nomination,0,0,1,1
Little Black Book,1 nomination.,0,0,1,1
Downfall,Nominated for 1 Oscar. Another 22 wins & 33 nominations.,1,22,33,56
The Bourne Supremacy,5 wins & 22 nominations,0,5,22,27
50 First Dates,6 wins & 10 nominations.,0,6,10,16
She Hate Me,1 win & 7 nominations.,0,1,7,8
Bobby Jones: Stroke of Genius,1 nomination.,0,0,1,1
Sky Captain and the World of Tomorrow,8 wins & 19 nominations.,0,8,19,27
Vanity Fair,2 wins & 5 nominations,0,2,5,7
Maria Full of Grace,Nominated for 1 Oscar. Another 41 wins & 34 nominations.,1,41,34,76
Bridget Jones: The Edge of Reason,11 nominations.,0,0,11,11
Soul Plane,1 nomination.,0,0,1,1
Bride & Prejudice,1 win & 8 nominations.,0,1,8,9
Twisted,1 win,0,1,0,1
The Chronicles of Riddick,5 nominations.,0,0,5,5
"I, Robot",Nominated for 1 Oscar. Another 1 win & 14 nominations.,1,1,14,16
The Heart Is Deceitful Above All Things,1 win & 2 nominations.,0,1,2,3
The Chorus,,0,0,0,0
Sleepover,1 win & 3 nominations,0,1,3,4
Confessions of a Teenage Drama Queen,1 win.,0,1,0,1
Along Came Polly,1 win & 9 nominations,0,1,9,10
Turtles Can Fly,23 wins & 7 nominations.,0,23,7,30
Shrek 2,Nominated for 2 Oscars. Another 18 wins & 50 nominations.,2,18,50,70
Club Dread,,0,0,0,0
The Incredibles,Won 2 Oscars. Another 65 wins & 56 nominations.,2,65,56,123
Closer,Nominated for 2 Oscars. Another 22 wins & 48 nominations.,2,22,48,72
Sideways,Won 1 Oscar. Another 121 wins & 91 nominations.,1,121,91,213
Johnson Family Vacation,3 nominations.,0,0,3,3
Head of State,10 nominations.,0,0,10,10
Love Me If You Dare,5 wins & 2 nominations.,0,5,2,7
Mystic River,Won 2 Oscars. Another 54 wins & 144 nominations.,2,54,144,200
Love Don't Cost a Thing,6 nominations.,0,0,6,6
Veronica Guerin,Nominated for 1 Golden Globe. Another 3 wins & 13 nominations.,0,3,14,17
National Security,,0,0,0,0
M�s all� de las fronteras,,0,0,0,0
Looney Tunes: Back in Action,10 nominations.,0,0,10,10
Love Actually,Nominated for 2 Golden Globes. Another 10 wins & 27 nominations.,0,10,29,39
Lost in Translation,Won 1 Oscar. 97 wins & 132 nominations total,1,97,132,230
Ned Kelly,3 wins & 14 nominations.,0,3,14,17
Gothika,3 wins & 7 nominations.,0,3,7,10
Anger Management,2 wins & 4 nominations.,0,2,4,6
Girl with a Pearl Earring,Nominated for 3 Oscars. 17 wins & 46 nominations total,3,17,46,66
American Wedding,3 wins & 6 nominations.,0,3,6,9
American Splendor,Nominated for 1 Oscar. Another 31 wins & 49 nominations.,1,31,49,81
Grind,,0,0,0,0
Good Bye Lenin!,36 wins & 22 nominations total,0,36,22,58
Good Boy!,3 nominations.,0,0,3,3
Mona Lisa Smile,6 nominations,0,0,6,6
Gods and Generals,1 win & 4 nominations,0,1,4,5
Tokyo Godfathers,8 wins & 1 nomination.,0,8,1,9
All the Real Girls,4 wins & 11 nominations.,0,4,11,15
Matrix Revolutions,5 wins & 36 nominations.,0,5,36,41
Matchstick Men,5 nominations,0,0,5,5
Monster: Asesina en serie,,0,0,0,0
Master and Commander: The Far Side of the World,Won 2 Oscars. 23 wins & 90 nominations total,2,23,90,115
Uptown Girls,2 nominations.,0,0,2,2
Masked and Anonymous,1 win.,0,1,0,1
Timeline,,0,0,0,0
Gigli,12 wins & 13 nominations.,0,12,13,25
Gozu,5 wins & 3 nominations.,0,5,3,8
Malibu's Most Wanted,3 nominations.,0,0,3,3
Undead,3 wins & 4 nominations.,0,3,4,7
Time of the Wolf,2 wins & 1 nomination.,0,2,1,3
Under the Tuscan Sun,5 nominations.,0,0,5,5
Underworld,1 win & 10 nominations.,0,1,10,11
Tierra de osos,,0,0,0,0
Agent Cody Banks,5 nominations.,0,0,5,5
My Boss's Daughter,2 nominations.,0,0,2,2
Thirteen,Nominated for 1 Oscar. Another 14 wins & 48 nominations.,1,14,48,63
Lutero,,0,0,0,0
Anything Else,,0,0,0,0
Reconstruction,12 wins & 11 nominations.,0,12,11,23
From Justin to Kelly,3 wins & 19 nominations,0,3,19,22
Daddy Day Care,1 win & 6 nominations.,0,1,6,7
The Fighting Temptations,4 wins & 11 nominations.,0,4,11,15
B�sico y letal,,0,0,0,0
Darkness Falls,1 win & 2 nominations.,0,1,2,3
Bulletproof Monk,1 nomination,0,0,1,1
Stander,3 nominations.,0,0,3,3
Bruce Almighty,7 wins & 9 nominations.,0,7,9,16
Spy Kids 3: Game Over,,0,0,0,0
"Spring, Summer, Fall, Winter... and Spring",15 wins & 8 nominations.,0,15,8,23
The Green Butchers,7 wins & 8 nominations.,0,7,8,15
Bringing Down the House,4 wins & 13 nominations,0,4,13,17
Bright Young Things,10 nominations,0,0,10,10
Something's Gotta Give,Nominated for 1 Oscar. 8 wins & 13 nominations total,1,8,13,22
The Haunted Mansion,1 win & 4 nominations,0,1,4,5
Deliver Us from Eva,4 wins & 12 nominations.,0,4,12,16
The Human Stain,3 wins & 5 nominations.,0,3,5,8
Sinbad: Legend of the Seven Seas,9 nominations,0,0,9,9
Dickie Roberts: Former Child Star,1 win & 1 nomination.,0,1,1,2
The In-Laws,,0,0,0,0
Shattered Glass,11 wins & 28 nominations.,0,11,28,39
The Italian Job,7 wins & 9 nominations,0,7,9,16
Shanghai Knights,4 nominations.,0,0,4,4
The Jungle Book 2,1 win & 9 nominations.,0,1,9,10
Shade,,0,0,0,0
Dogville,21 wins & 33 nominations.,0,21,33,54
Calendar Girls,Nominated for 1 Golden Globe. Another 2 wins & 15 nominations.,0,2,16,18
Stuck on You,2 nominations.,0,0,2,2
The Visual Bible: The Gospel of John,,0,0,0,0
Camp,6 nominations,0,0,6,6
The Blind Swordsman: Zatoichi,,0,0,0,0
The Best of Youth,,0,0,0,0
The Cat in the Hat,7 wins & 22 nominations.,0,7,22,29
The Battle of Shaker Heights,,0,0,0,0
The Barbarian Invasions,Won 1 Oscar. Another 49 wins & 37 nominations.,1,49,37,87
Code 46,4 wins & 10 nominations,0,4,10,14
Coffee and Cigarettes,2 wins & 9 nominations.,0,2,9,11
Cold Creek Manor,1 nomination.,0,0,1,1
Cold Mountain,Won 1 Oscar. 20 wins & 101 nominations total,1,20,101,122
The Company,2 nominations.,0,0,2,2
Cheaper by the Dozen,2 wins & 7 nominations.,0,2,7,9
The Cooler,Nominated for 1 Oscar. Another 9 wins & 25 nominations.,1,9,25,35
The Core,,0,0,0,0
Chasing Papi,1 nomination,0,0,1,1
Confidence,,0,0,0,0
Terminator 3: Rise of the Machines,3 wins & 24 nominations.,0,3,24,27
Charlie's Angels: Full Throttle,9 wins & 21 nominations.,0,9,21,30
Tears of the Sun,2 nominations.,0,0,2,2
Cradle 2 the Grave,6 nominations.,0,0,6,6
The Divorce,2 wins.,0,2,0,2
Sylvia,1 win.,0,1,0,1
The Dreamers,2 wins & 10 nominations.,0,2,10,12
Swimming Pool: juegos perversos,,0,0,0,0
Carandiru,16 wins & 33 nominations,0,16,33,49
Dorm Daze,,0,0,0,0
Dot the I,1 win & 1 nomination.,0,1,1,2
Secondhand Lions,1 win & 6 nominations.,0,1,6,7
Seabiscuit,Nominated for 7 Oscars. Another 6 wins & 37 nominations.,7,6,37,50
The Rundown,2 wins & 3 nominations,0,2,3,5
Barely Legal,,0,0,0,0
Piglet's Big Movie,1 nomination.,0,0,1,1
Pieces of April,Nominated for 1 Oscar. 15 wins & 22 nominations total,1,15,22,38
Peter Pan,2 nominations.,0,0,2,2
Paycheck,3 wins & 2 nominations.,0,3,2,5
Bad Santa,1 win & 12 nominations.,0,1,12,13
Party Monster,4 nominations.,0,0,4,4
The Singing Detective,1 win & 3 nominations.,0,1,3,4
Final Destination 2,4 nominations.,0,0,4,4
Finding Nemo,Won 1 Oscar. Another 47 wins & 63 nominations.,1,47,63,111
Bad Boys II,5 wins & 13 nominations.,0,5,13,18
Owning Mahowny,3 wins & 5 nominations.,0,3,5,8
Out of Time,5 wins & 7 nominations.,0,5,7,12
The Station Agent,29 wins & 31 nominations total,0,29,31,60
Open Water,2 wins & 6 nominations.,0,2,6,8
Open Range,1 win & 5 nominations,0,1,5,6
Ong-Bak: The Thai Warrior,2 wins & 5 nominations.,0,2,5,7
Baadasssss!,3 wins & 11 nominations.,0,3,11,14
Once Upon a Time in Mexico,3 wins & 6 nominations.,0,3,6,9
The Texas Chainsaw Massacre,4 wins & 17 nominations,0,4,17,21
Oldboy: Cinco d�as para vengarse,,0,0,0,0
Old School,5 nominations.,0,0,5,5
The Triplets of Belleville,Nominated for 2 Oscars. Another 20 wins & 39 nominations.,2,20,39,61
Freaky Friday,5 wins & 11 nominations.,0,5,11,16
The United States of Leland,1 win & 2 nominations.,0,1,2,3
Freddy vs. Jason,2 wins & 11 nominations.,0,2,11,13
Pirates of the Caribbean: The Curse of the Black Pearl,Nominated for 5 Oscars. Another 38 wins & 99 nominations.,5,38,99,142
The Room,1 win.,0,1,0,1
Biker Boyz,,0,0,0,0
Down with Love,4 wins & 8 nominations,0,4,8,12
School of Rock,8 wins & 23 nominations.,0,8,23,31
The Last Samurai,Nominated for 4 Oscars. Another 20 wins & 63 nominations.,4,20,63,87
Scary Movie 3,2 wins & 4 nominations.,0,2,4,6
The League of Extraordinary Gentlemen,12 nominations.,0,0,12,12
The Life of David Gale,3 nominations.,0,0,3,3
Dreamcatcher,5 nominations.,0,0,5,5
Saints and Soldiers,16 wins & 2 nominations.,0,16,2,18
The Lizzie McGuire Movie,2 wins & 3 nominations.,0,2,3,5
S.W.A.T.,5 wins & 5 nominations,0,5,5,10
The Lord of the Rings: The Return of the King,Won 11 Oscars. Another 198 wins & 124 nominations.,11,198,124,333
Runaway Jury,1 win & 3 nominations.,0,1,3,4
Rugrats Go Wild,2 nominations.,0,0,2,2
The Recruit,2 nominations,0,0,2,2
Dumb and Dumberer: When Harry Met Lloyd,1 win & 7 nominations.,0,1,7,8
Big Fish,Nominated for 1 Oscar. Another 68 nominations.,1,0,68,69
Duplex,2 nominations,0,0,2,2
The Matrix Reloaded,8 wins & 34 nominations.,0,8,34,42
The Medallion,2 nominations.,0,0,2,2
The Memory of a Killer,7 wins & 3 nominations.,0,7,3,10
The Missing,2 wins & 8 nominations.,0,2,8,10
The Mother,Nominated for 1 BAFTA Film Award. Another 2 wins & 12 nominations.,0,2,13,15
Elephant,8 wins & 13 nominations.,0,8,13,21
Elf,2 wins & 7 nominations.,0,2,7,9
Radio,3 wins & 5 nominations,0,3,5,8
View from the Top,1 nomination.,0,0,1,1
The Shape of Things,1 nomination.,0,0,1,1
It's All About Love,3 wins.,0,3,0,3
How to Deal,,0,0,0,0
Intolerable Cruelty,3 nominations,0,0,3,3
I'm Not Scared,14 wins & 18 nominations.,0,14,18,32
Intermission,9 wins & 12 nominations.,0,9,12,21
2 Fast 2 Furious,4 wins & 13 nominations.,0,4,13,17
Honey,8 nominations.,0,0,8,8
Holes,3 wins & 9 nominations.,0,3,9,12
What a Girl Wants,1 win.,0,1,0,1
Hollywood Homicide,1 win,0,1,0,1
"Legally Blonde 2: Red, White & Blonde",,0,0,0,0
Willard,1 win & 5 nominations.,0,1,5,6
I Am David,8 wins & 1 nomination.,0,8,1,9
House of Sand and Fog,Nominated for 3 Oscars. 13 wins & 42 nominations total,3,13,42,58
Kangaroo Jack,1 win & 9 nominations.,0,1,9,10
House of 1000 Corpses,4 wins & 8 nominations.,0,4,8,12
House of the Dead,2 wins.,0,2,0,2
Johnny English,6 nominations,0,0,6,6
Young Adam,7 wins & 17 nominations.,0,7,17,24
Identity,1 win & 11 nominations.,0,1,11,12
Kontroll,19 wins & 5 nominations,0,19,5,24
X-Men 2,,0,0,0,0
I'll Sleep When I'm Dead,1 nomination.,0,0,1,1
La vida sin m�,,0,0,0,0
In the Cut,1 win & 2 nominations.,0,1,2,3
Just Married,8 nominations.,0,0,8,8
Wonderland,3 nominations,0,0,3,3
Latter Days,3 wins.,0,3,0,3
I Capture the Castle,2 wins & 4 nominations,0,2,4,6
Jeepers Creepers II,,0,0,0,0
Japanese Story,20 wins & 13 nominations.,0,20,13,33
A Man Apart,1 nomination,0,0,1,1
21 Grams,Nominated for 2 Oscars. 30 wins & 79 nominations total,2,30,79,111
Hulk,3 wins & 14 nominations.,0,3,14,17
A Guy Thing,,0,0,0,0
Kill Bill: Vol. 1,29 wins & 103 nominations total,0,29,103,132
A Mighty Wind,Nominated for 1 Oscar. 14 wins & 28 nominations total,1,14,28,43
Lara Croft Tomb Raider: The Cradle of Life,1 win & 3 nominations.,0,1,3,4
Wrong Turn,3 nominations,0,0,3,3
How to Lose a Guy in 10 Days,1 win & 8 nominations,0,1,8,9
High Tension,,0,0,0,0
High Crimes,2 nominations.,0,0,2,2
I Spy,2 wins & 6 nominations.,0,2,6,8
The Pianist,Won 3 Oscars. 57 wins & 74 nominations total,3,57,74,134
Ghost Ship,1 nomination,0,0,1,1
Divine Secrets of the Ya-Ya Sisterhood,1 win & 7 nominations.,0,1,7,8
Halloween: Resurrection,1 win & 1 nomination.,0,1,1,2
All About the Benjamins,,0,0,0,0
28 Days Later...,10 wins & 32 nominations.,0,10,32,42
Pumpkin,3 nominations.,0,0,3,3
Punch-Drunk Love,14 wins & 37 nominations.,0,14,37,51
Ju-on: The Grudge,1 win & 1 nomination.,0,1,1,2
Minority Report,Nominated for 1 Oscar. Another 20 wins & 90 nominations.,1,20,90,111
Two Weeks Notice,2 wins & 3 nominations,0,2,3,5
The Master of Disguise,1 win & 6 nominations.,0,1,6,7
The Transporter,,0,0,0,0
Showtime,1 win & 6 nominations.,0,1,6,7
40 Days and 40 Nights,1 win & 2 nominations.,0,1,2,3
K-19: The Widowmaker,1 win & 2 nominations.,0,1,2,3
The Quiet American,Nominated for 1 Oscar. Another 13 wins & 13 nominations.,1,13,13,27
Juwanna Mann,1 nomination.,0,0,1,1
The Truth About Charlie,2 nominations.,0,0,2,2
The Tuxedo,2 wins & 1 nomination.,0,2,1,3
Bubba Ho-Tep,7 wins & 10 nominations.,0,7,10,17
Tierra de sue�os,,0,0,0,0
Boat Trip,1 win & 8 nominations.,0,1,8,9
Evelyn,4 wins & 7 nominations.,0,4,7,11
8 Women,11 wins & 31 nominations.,0,11,31,42
Cerca de la libertad,,0,0,0,0
Asterix and Obelix Meet Cleopatra,,0,0,0,0
Roger Dodger,12 wins & 14 nominations.,0,12,14,26
xXx,4 wins & 14 nominations.,0,4,14,18
Blue Crush,1 win & 7 nominations.,0,1,7,8
Dirty Pretty Things,Nominated for 1 Oscar. Another 16 wins & 27 nominations.,1,16,27,44
The Powerpuff Girls Movie,,0,0,0,0
Analyze That,1 win.,0,1,0,1
Blood Work,2 wins,0,2,0,2
Bloody Sunday,19 wins & 23 nominations.,0,19,23,42
Reign of Fire,1 win & 3 nominations,0,1,3,4
Cabin Fever,3 wins & 12 nominations.,0,3,12,15
Antwone Fisher,19 wins & 22 nominations.,0,19,22,41
Eight Crazy Nights,1 win & 5 nominations.,0,1,5,6
Below,2 nominations,0,0,2,2
Narc,1 win & 8 nominations,0,1,8,9
Real Women Have Curves,8 wins & 4 nominations.,0,8,4,12
Stuart Little 2,1 win & 4 nominations total,0,1,4,5
Bend It Like Beckham,17 wins & 20 nominations.,0,17,20,37
Secretary,15 wins & 26 nominations.,0,15,26,41
Murder by Numbers,2 nominations.,0,0,2,2
The Country Bears,4 nominations.,0,0,4,4
Gangs of New York,Nominated for 10 Oscars. Another 50 wins & 125 nominations.,10,50,125,185
Eight Legged Freaks,1 nomination.,0,0,1,1
Star Wars: Episode II - Attack of the Clones,Nominated for 1 Oscar. Another 19 wins & 64 nominations.,1,19,64,84
Gerry,2 wins & 9 nominations.,0,2,9,11
They,1 win & 1 nomination.,0,1,1,2
Dahmer,3 nominations.,0,0,3,3
State Property,,0,0,0,0
The New Guy,1 nomination,0,0,1,1
Scooby-Doo,5 wins & 14 nominations.,0,5,14,19
Resident Evil,7 nominations.,0,0,7,7
The Mothman Prophecies,1 win & 2 nominations.,0,1,2,3
Blade II,6 wins & 10 nominations.,0,6,10,16
Men in Black II,4 wins & 16 nominations,0,4,16,20
Treasure Planet,Nominated for 1 Oscar. 1 win & 14 nominations total,1,1,14,16
Trapped,,0,0,0,0
El crimen del padre Amaro,Nominated for 1 Oscar. 21 wins & 15 nominations total,1,21,15,37
Hey Arnold! The Movie,1 nomination.,0,0,1,1
Mujer fatal,,0,0,0,0
The Good Girl,5 wins & 16 nominations.,0,5,16,21
Hollywood Ending,1 nomination,0,0,1,1
Half Past Dead,4 nominations.,0,0,4,4
Changing Lanes,7 nominations.,0,0,7,7
Queen of the Damned,7 nominations,0,0,7,7
Frida,Won 2 Oscars. Another 15 wins & 47 nominations.,2,15,47,64
Clockstoppers,,0,0,0,0
Friday After Next,,0,0,0,0
Equilibrium,2 nominations.,0,0,2,2
Igby Goes Down,7 wins & 17 nominations.,0,7,17,24
All or Nothing,3 wins & 13 nominations.,0,3,13,16
Confessions of a Dangerous Mind,7 wins & 12 nominations,0,7,12,19
Nicholas Nickleby,Nominated for 1 Golden Globe. Another 1 win & 4 nominations.,0,1,5,6
Serving Sara,,0,0,0,0
Drag�n rojo,,0,0,0,0
The Banger Sisters,1 win & 1 nomination,0,1,1,2
Dragonfly,1 nomination.,0,0,1,1
The Count of Monte Cristo,,0,0,0,0
The Wild Thornberrys Movie,,0,0,0,0
New Best Friend,,0,0,0,0
Road to Perdition,Won 1 Oscar. Another 22 wins & 82 nominations.,1,22,82,105
Enough,4 nominations.,0,0,4,4
Star Trek: Nemesis,1 win & 4 nominations.,0,1,4,5
Sendero de sangre,,0,0,0,0
May,9 wins & 8 nominations.,0,9,8,17
Tuck Everlasting,1 win & 3 nominations.,0,1,3,4
Full Frontal,1 nomination.,0,0,1,1
Collateral Damage,,0,0,0,0
L'auberge espagnole,,0,0,0,0
Spider,13 wins & 25 nominations.,0,13,25,38
Moonlight Mile,1 win & 6 nominations,0,1,6,7
Barbershop,1 win & 17 nominations.,0,1,17,18
Solaris,5 wins & 4 nominations.,0,5,4,9
The Santa Clause 2,1 win & 3 nominations.,0,1,3,4
Peter Pan II: Return to Neverland,,0,0,0,0
So Close,1 nomination.,0,0,1,1
The Emperor's Club,2 nominations.,0,0,2,2
The Salton Sea,1 win.,0,1,0,1
Catch Me If You Can,Nominated for 2 Oscars. Another 16 wins & 44 nominations.,2,16,44,62
Phone Booth,1 win & 8 nominations.,0,1,8,9
Van Wilder: Party Liaison,,0,0,0,0
Dark Blue,4 nominations,0,0,4,4
Snow Dogs,1 win,0,1,0,1
Pinocchio,Won 2 Oscars. Another 5 wins.,2,5,0,7
The Magdalene Sisters,Nominated for 1 BAFTA Film Award. Another 18 wins & 14 nominations.,0,18,15,33
Abandon,1 nomination,0,0,1,1
The Sum of All Fears,2 wins & 5 nominations,0,2,5,7
Chicago,Won 6 Oscars. Another 51 wins & 129 nominations.,6,51,129,186
S1m0ne,1 nomination,0,0,1,1
The Rules of Attraction,2 wins & 3 nominations,0,2,3,5
About Schmidt,Nominated for 2 Oscars. Another 25 wins & 69 nominations.,2,25,69,96
Lilya 4-Ever,,0,0,0,0
Far from Heaven,Nominated for 4 Oscars. 102 wins & 96 nominations total,4,102,96,202
About a Boy,Nominated for 1 Oscar. 11 wins & 30 nominations total,1,11,30,42
Lilo & Stitch,Nominated for 1 Oscar. Another 10 wins & 26 nominations.,1,10,26,37
Mr. Deeds,5 wins & 9 nominations,0,5,9,14
Kung Pow: Enter the Fist,1 win & 1 nomination,0,1,1,2
Darkness,2 wins & 3 nominations,0,2,3,5
Spider-Man,Nominated for 2 Oscars. Another 16 wins & 61 nominations.,2,16,61,79
Sweet Home Alabama,3 wins & 6 nominations,0,3,6,9
The Scorpion King,2 wins & 3 nominations,0,2,3,5
The Lord of the Rings: The Two Towers,Won 2 Oscars. Another 124 wins & 138 nominations.,2,124,138,264
Drumline,13 nominations.,0,0,13,13
City of God,Nominated for 4 Oscars. Another 74 wins & 46 nominations.,4,74,46,124
The Four Feathers,,0,0,0,0
Mondays in the Sun,,0,0,0,0
25th Hour,Nominated for 1 Golden Globe. Another 4 wins & 16 nominations.,0,4,17,21
Ice Age,Nominated for 1 Oscar. Another 5 wins & 29 nominations.,1,5,29,35
Ballistic: Ecks vs. Sever,5 nominations,0,0,5,5
The Slaughter Rule,2 wins & 2 nominations.,0,2,2,4
City of Ghosts,1 nomination.,0,0,1,1
Swimfan,,0,0,0,0
The Bourne Identity,3 wins & 6 nominations,0,3,6,9
Swept Away,8 wins & 8 nominations.,0,8,8,16
The Guru,1 nomination.,0,0,1,1
Feardotcom,3 wins & 3 nominations.,0,3,3,6
Death to Smoochy,2 nominations.,0,0,2,2
Sorority Boys,1 win & 1 nomination,0,1,1,2
Panic Room,1 win & 9 nominations.,0,1,9,10
City by the Sea,1 nomination,0,0,1,1
We Were Soldiers,3 wins & 5 nominations,0,3,5,8
Sonny,1 nomination.,0,0,1,1
Casarse... est� en griego,,0,0,0,0
Paid in Full,1 nomination.,0,0,1,1
Heaven,6 wins & 7 nominations.,0,6,7,13
Sweet Sixteen,10 wins & 17 nominations.,0,10,17,27
Sympathy for Mr. Vengeance,,0,0,0,0
XX/XY,1 nomination.,0,0,1,1
24 Hour Party People,1 win & 13 nominations,0,1,13,14
A Walk to Remember,4 wins & 2 nominations.,0,4,2,6
The Hot Chick,4 nominations.,0,0,4,4
The Time Machine,Nominated for 1 Oscar. 2 wins & 4 nominations total,1,2,4,7
Big Fat Liar,1 win & 3 nominations.,0,1,3,4
Rollerball,5 wins & 3 nominations,0,5,3,8
The Ring,14 wins & 12 nominations,0,14,12,26
Poolhall Junkies,1 nomination.,0,0,1,1
Deuces Wild,1 win & 1 nomination.,0,1,1,2
Austin Powers in Goldmember,5 wins & 22 nominations.,0,5,22,27
Die Another Day,6 wins & 36 nominations.,0,6,36,42
The Importance of Being Earnest,2 wins & 2 nominations.,0,2,2,4
Laurel Canyon,2 wins & 6 nominations.,0,2,6,8
Signs,3 wins & 34 nominations.,0,3,34,37
Life or Something Like It,1 nomination.,0,0,1,1
Undercover Brother,1 win & 7 nominations.,0,1,7,8
The Reckoning,2 nominations.,0,0,2,2
The Man Without a Past,Nominated for 1 Oscar. Another 21 wins & 26 nominations.,1,21,26,48
Waking Up in Reno,,0,0,0,0
Windtalkers,3 wins & 4 nominations,0,3,4,7
Possession,5 wins & 4 nominations.,0,5,4,9
Spun,2 nominations.,0,0,2,2
Unfaithful,Nominated for 1 Oscar. Another 3 wins & 15 nominations.,1,3,15,19
Auto Focus,6 nominations,0,0,6,6
Welcome to Collinwood,2 nominations,0,0,2,2
Harry Potter and the Chamber of Secrets,Nominated for 3 BAFTA Film Awards. Another 13 wins & 43 nominations.,0,13,46,59
The Adventures of Pluto Nash,1 win & 12 nominations.,0,1,12,13
Talk to Her,Won 1 Oscar. Another 45 wins & 47 nominations.,1,45,47,93
Undisputed,2 nominations,0,0,2,2
Eye See You,,0,0,0,0
One Hour Photo,6 wins & 22 nominations,0,6,22,28
Infernal Affairs,24 wins & 26 nominations.,0,24,26,50
Hart's War,1 win & 1 nomination,0,1,1,2
Spirit: Stallion of the Cimarron,Nominated for 1 Oscar. 10 wins & 22 nominations total,1,10,22,33
Better Luck Tomorrow,1 win & 2 nominations.,0,1,2,3
Big Trouble,,0,0,0,0
8 Mile,Won 1 Oscar. Another 14 wins & 21 nominations.,1,14,21,36
The Hours,Won 1 Oscar. Another 42 wins & 126 nominations.,1,42,126,169
Like Mike,1 win & 6 nominations.,0,1,6,7
White Oleander,3 wins & 7 nominations.,0,3,7,10
Orange County,3 nominations.,0,0,3,3
Maid in Manhattan,1 win & 8 nominations.,0,1,8,9
Open Hearts,12 wins & 12 nominations.,0,12,12,24
Slackers,,0,0,0,0
Spy Kids 2: Island of Lost Dreams,3 wins & 3 nominations.,0,3,3,6
Adaptation.,Won 1 Oscar. 65 wins & 100 nominations total,1,65,100,166
He Loves Me... He Loves Me Not,,0,0,0,0
The Sweetest Thing,1 win & 4 nominations.,0,1,4,5
John Q,2 wins & 8 nominations.,0,2,8,10
Morvern Callar,10 wins & 16 nominations.,0,10,16,26
La leyenda de las ballenas,,0,0,0,0
Brown Sugar,2 wins & 18 nominations.,0,2,18,20
Angel Eyes,3 wins & 5 nominations,0,3,5,8
The Mummy Returns,6 wins & 19 nominations,0,6,19,25
Monsoon Wedding,Nominated for 1 Golden Globe. Another 7 wins & 11 nominations.,0,7,12,19
Iris,Won 1 Oscar. Another 13 wins & 31 nominations.,1,13,31,45
Ghosts of Mars,2 nominations,0,0,2,2
CQ,1 nomination.,0,0,1,1
Monster's Ball,Won 1 Oscar. Another 14 wins & 23 nominations.,1,14,23,38
The Forsaken,,0,0,0,0
Storytelling,1 nomination.,0,0,1,1
Human Nature,2 wins & 2 nominations,0,2,2,4
The Affair of the Necklace,Nominated for 1 Oscar. Another 1 win & 1 nomination.,1,1,1,3
The Majestic,3 wins & 1 nomination.,0,3,1,4
Rock Star,1 nomination,0,0,1,1
"Monsters, Inc.",Won 1 Oscar. 15 wins & 38 nominations total,1,15,38,54
Ghost World,Nominated for 1 Oscar. Another 28 wins & 55 nominations.,1,28,55,84
In the Bedroom,Nominated for 5 Oscars. Another 39 wins & 70 nominations.,5,39,70,114
Mostly Martha,14 wins & 7 nominations.,0,14,7,21
Glitter,3 wins & 10 nominations,0,3,10,13
Mulholland Drive,,0,0,0,0
The Mexican,3 wins & 2 nominations.,0,3,2,5
The Man Who Wasn't There,Nominated for 1 Oscar. Another 25 wins & 42 nominations.,1,25,42,68
Get Over It,4 nominations.,0,0,4,4
Riding in Cars with Boys,2 wins & 2 nominations.,0,2,2,4
Kate & Leopold,Nominated for 1 Oscar. 1 win & 5 nominations total,1,1,5,7
El demonio,,0,0,0,0
Impostor,1 nomination.,0,0,1,1
What's the Worst That Could Happen?,,0,0,0,0
One Night at McCool's,,0,0,0,0
The Tailor of Panama,1 win & 1 nomination,0,1,1,2
The Deep End,Nominated for 1 Golden Globe. Another 4 wins & 18 nominations.,0,4,19,23
Pootie Tang,1 nomination.,0,0,1,1
A Knight's Tale,4 wins & 13 nominations.,0,4,13,17
Crush,,0,0,0,0
On the Line,4 nominations.,0,0,4,4
Super Troopers,1 win.,0,1,0,1
Planet of the Apes,Nominated for 2 BAFTA Film Awards. Another 11 wins & 30 nominations.,0,11,32,43
Crazy/Beautiful,5 nominations.,0,0,5,5
Captain Corelli's Mandolin,2 wins & 5 nominations.,0,2,5,7
Kissing Jessica Stein,8 wins & 3 nominations.,0,8,3,11
Exit Wounds,4 nominations,0,0,4,4
Evolution,2 nominations.,0,0,2,2
Ocean's Eleven,4 wins & 20 nominations.,0,4,20,24
Atlantis: The Lost Empire,2 wins & 14 nominations.,0,2,14,16
O,1 win & 1 nomination.,0,1,1,2
Original Sin,2 nominations.,0,0,2,2
The Royal Tenenbaums,Nominated for 1 Oscar. Another 11 wins & 45 nominations.,1,11,45,57
Kiss of the Dragon,2 nominations,0,0,2,2
Sweet November,3 nominations.,0,0,3,3
Final Fantasy: The Spirits Within,3 wins & 11 nominations,0,3,11,14
Parejas en conflicto,,0,0,0,0
L.I.E.,20 wins & 18 nominations.,0,20,18,38
Pearl Harbor,Won 1 Oscar. Another 13 wins & 51 nominations.,1,13,51,65
Swordfish,5 wins & 10 nominations.,0,5,10,15
Bandits,4 wins & 7 nominations,0,4,7,11
The Son's Room,16 wins & 28 nominations.,0,16,28,44
The Score,1 win & 1 nomination.,0,1,1,2
Osmosis Jones,1 win & 8 nominations.,0,1,8,9
The Safety of Objects,3 wins & 4 nominations.,0,3,4,7
Baby Boy,1 win & 14 nominations.,0,1,14,15
Cats & Dogs,11 wins & 7 nominations.,0,11,7,18
The Devil's Backbone,,0,0,0,0
Knockaround Guys,2 nominations.,0,0,2,2
Atanarjuat: The Fast Runner,26 wins & 18 nominations.,0,26,18,44
Formula 51,1 nomination.,0,0,1,1
Thirteen Conversations About One Thing,8 wins & 7 nominations.,0,8,7,15
Read My Lips,7 wins & 12 nominations.,0,7,12,19
Charlotte Gray,6 nominations.,0,0,6,6
Corky Romano,1 nomination.,0,0,1,1
Enigma,3 wins & 6 nominations.,0,3,6,9
Enemy at the Gates,7 nominations.,0,0,7,7
Lagaan: Once Upon a Time in India,Nominated for 1 Oscar. Another 54 wins & 19 nominations.,1,54,19,74
The Other Side of Heaven,1 win.,0,1,0,1
Rat Race,3 nominations.,0,0,3,3
Antitrust,2 wins & 4 nominations,0,2,4,6
Wet Hot American Summer,1 nomination.,0,0,1,1
The Curse of the Jade Scorpion,1 win & 1 nomination.,0,1,1,2
Recess: School's Out,,0,0,0,0
The One,4 nominations,0,0,4,4
En alg�n lugar de �frica,,0,0,0,0
Lara Croft: Tomb Raider,4 wins & 21 nominations.,0,4,21,25
Texas Rangers,,0,0,0,0
The Fast and the Furious,11 wins & 18 nominations.,0,11,18,29
Thir13en Ghosts,1 win & 4 nominations,0,1,4,5
El mosquetero,,0,0,0,0
From Hell,15 nominations.,0,0,15,15
The Experiment,14 wins & 14 nominations.,0,14,14,28
15 Minutes,1 nomination.,0,0,1,1
Not Another Teen Movie,5 nominations.,0,0,5,5
The Princess Diaries,3 wins & 11 nominations.,0,3,11,14
Frailty,5 wins & 16 nominations.,0,5,16,21
Tape,1 win & 1 nomination,0,1,1,2
Ashoka the Great,,0,0,0,0
Freddy Got Fingered,12 wins & 7 nominations,0,12,7,19
The Pledge,1 win & 6 nominations.,0,1,6,7
Estrenando Cuerpo,,0,0,0,0
Summer Catch,1 nomination.,0,0,1,1
The Piano Teacher,Nominated for 1 BAFTA Film Award. Another 18 wins & 22 nominations.,0,18,23,41
Kingdom Come,1 win & 6 nominations.,0,1,6,7
How High,,0,0,0,0
The Wash,,0,0,0,0
Sugar & Spice,2 wins & 7 nominations.,0,2,7,9
The Wedding Planner,2 wins & 6 nominations.,0,2,6,8
Monkeybone,3 nominations.,0,0,3,3
The Shipping News,Nominated for 2 BAFTA Film Awards. Another 2 wins & 11 nominations.,0,2,13,15
Waking Life,5 wins & 21 nominations,0,5,21,26
Spy Kids,2 wins & 10 nominations.,0,2,10,12
Brotherhood of the Wolf,4 wins & 22 nominations.,0,4,22,26
Dr. Dolittle 2,3 wins & 6 nominations.,0,3,6,9
American Outlaws,7 nominations,0,0,7,7
Cocodrilo Dundee en Hollywood,,0,0,0,0
Made,1 nomination.,0,0,1,1
Hardball,2 nominations.,0,0,2,2
Jurassic Park III,5 wins & 16 nominations.,0,5,16,21
Ali,Nominated for 2 Oscars. 10 wins & 27 nominations total,2,10,27,39
Josie and the Pussycats,5 nominations.,0,0,5,5
Shrek,Won 1 Oscar. Another 39 wins & 60 nominations.,1,39,60,100
Intacto,12 wins & 9 nominations.,0,12,9,21
Jay and Silent Bob Strike Back,1 win & 3 nominations.,0,1,3,4
The Last Castle,1 win & 4 nominations.,0,1,4,5
I Am Sam,Nominated for 1 Oscar. 8 wins & 12 nominations total,1,8,12,21
Scary Movie 2,3 wins & 5 nominations.,0,3,5,8
Harry Potter and the Sorcerer's Stone,Nominated for 3 Oscars. Another 17 wins & 65 nominations.,3,17,65,85
Life as a House,Nominated for 1 Golden Globe. Another 2 wins & 8 nominations.,0,2,9,11
American Pie 2,8 wins & 6 nominations,0,8,6,14
Say It Isn't So,1 nomination.,0,0,1,1
Spirited Away,Won 1 Oscar. Another 57 wins & 31 nominations.,1,57,31,89
Saving Silverman,,0,0,0,0
Lovely & Amazing,1 nomination.,0,0,1,1
Head Over Heels,,0,0,0,0
Amor en rojo,,0,0,0,0
Valentine,2 wins & 2 nominations.,0,2,2,4
Black Knight,2 nominations.,0,0,2,2
Training Day,Won 1 Oscar. 18 wins & 23 nominations total,1,18,23,42
Save the Last Dance,6 wins & 8 nominations.,0,6,8,14
Black Hawk Down,Won 2 Oscars. Another 9 wins & 37 nominations.,2,9,37,48
Gosford Park,Won 1 Oscar. Another 35 wins & 74 nominations.,1,35,74,110
Secret Ballot,10 wins & 5 nominations.,0,10,5,15
Hannibal,9 wins & 25 nominations,0,9,25,34
Millennium Actress,6 wins & 8 nominations.,0,6,8,14
Serendipity,3 nominations.,0,0,3,3
The Believer,6 wins & 10 nominations.,0,6,10,16
Jason X,1 nomination,0,0,1,1
Max Keeble's Big Move,1 win & 1 nomination.,0,1,1,2
The Caveman's Valentine,4 nominations.,0,0,4,4
Shallow Hal,3 nominations,0,0,3,3
Don't Say a Word,1 nomination.,0,0,1,1
The Glass House,3 nominations,0,0,3,3
America's Sweethearts,1 win & 2 nominations.,0,1,2,3
Buffalo Soldiers,1 win & 6 nominations,0,1,6,7
Session 9,2 wins & 3 nominations.,0,2,3,5
Domestic Disturbance,1 win & 3 nominations.,0,1,3,4
Juego de esp�as,,0,0,0,0
Sex and Lucia,,0,0,0,0
Two Can Play That Game,7 nominations.,0,0,7,7
Shaolin Soccer,,0,0,0,0
Donnie Darko,12 wins & 16 nominations.,0,12,16,28
Joy Ride,5 nominations.,0,0,5,5
Blow,3 wins & 9 nominations,0,3,9,12
Me Without You,2 nominations.,0,0,2,2
Wasabi,,0,0,0,0
Manic,1 nomination.,0,0,1,1
Along Came a Spider,1 win & 1 nomination.,0,1,1,2
Blow Dry,,0,0,0,0
Bubble Boy,1 nomination.,0,0,1,1
Mean Machine,,0,0,0,0
See Spot Run,1 nomination.,0,0,1,1
3000 Miles to Graceland,13 nominations.,0,0,13,13
Intimidad,2 wins.,0,2,0,2
Bully,3 wins & 1 nomination,0,3,1,4
The Cat's Meow,1 win & 1 nomination.,0,1,1,2
Zoolander,1 win & 11 nominations,0,1,11,12
Dog Days,7 wins & 3 nominations.,0,7,3,10
Legally Blonde,Nominated for 2 Golden Globes. Another 6 wins & 12 nominations.,0,6,14,20
Joe Dirt,1 win & 3 nominations,0,1,3,4
Town & Country,2 wins & 1 nomination.,0,2,1,3
Am�lie,,0,0,0,0
The Anniversary Party,2 wins & 6 nominations.,0,2,6,8
An American Rhapsody,5 wins & 5 nominations.,0,5,5,10
The Grey Zone,1 win & 3 nominations,0,1,3,4
Hearts in Atlantis,2 wins & 8 nominations.,0,2,8,10
The Lord of the Rings: The Fellowship of the Ring,Won 4 Oscars. Another 117 wins & 126 nominations.,4,117,126,247
Rush Hour 2,10 wins & 22 nominations.,0,10,22,32
Tortilla Soup,2 wins & 7 nominations.,0,2,7,9
Someone Like You...,,0,0,0,0
A.I. Artificial Intelligence,Nominated for 2 Oscars. Another 17 wins & 69 nominations.,2,17,69,88
The Brothers,1 win & 8 nominations.,0,1,8,9
Heist,,0,0,0,0
Soul Survivors,,0,0,0,0
Little Secrets,2 wins & 2 nominations.,0,2,2,4
The Animal,6 nominations.,0,0,6,6
Joe Somebody,1 nomination,0,0,1,1
Jimmy Neutron: Boy Genius,Nominated for 1 Oscar. Another 5 nominations.,1,0,5,6
K-PAX,3 nominations.,0,0,3,3
Bridget Jones's Diary,Nominated for 1 Oscar. 8 wins & 32 nominations total,1,8,32,41
Hedwig and the Angry Inch,Nominated for 1 Golden Globe. Another 28 wins & 32 nominations.,0,28,33,61
A Beautiful Mind,Won 4 Oscars. Another 33 wins & 69 nominations.,4,33,69,106
Vanilla Sky,Nominated for 1 Oscar. Another 5 wins & 33 nominations.,1,5,33,39
Driven,1 win & 10 nominations.,0,1,10,11
Y Tu Mam� Tambi�n,,0,0,0,0
Birthday Girl,1 win.,0,1,0,1
Son of the Bride,Nominated for 1 Oscar. Another 35 wins & 11 nominations.,1,35,11,47
Heartbreakers,4 nominations.,0,0,4,4
Lost and Delirious,4 wins & 6 nominations.,0,4,6,10
Bride of the Wind,,0,0,0,0
Just Visiting,,0,0,0,0
Tomcats,2 nominations,0,0,2,2
Dinosaur,4 wins & 21 nominations.,0,4,21,25
Lockdown,,0,0,0,0
U-571: La batalla del Atl�ntico,,0,0,0,0
Hanging Up,2 wins & 1 nomination,0,2,1,3
Panic,2 nominations.,0,0,2,2
Sordid Lives,10 wins.,0,10,0,10
What Women Want,Nominated for 1 Golden Globe. Another 5 wins & 8 nominations.,0,5,9,14
Proof of Life,5 nominations.,0,0,5,5
Italiano para principiantes,,0,0,0,0
Snow Day,4 nominations.,0,0,4,4
What Planet Are You From?,1 nomination,0,0,1,1
Bedazzled,1 win & 3 nominations,0,1,3,4
Quills,Nominated for 3 Oscars. Another 18 wins & 42 nominations.,3,18,42,63
The Watcher,2 nominations.,0,0,2,2
The Cell,Nominated for 1 Oscar. Another 9 wins & 28 nominations.,1,9,28,38
Sexy Beast,Nominated for 1 Oscar. 21 wins & 21 nominations total,1,21,21,43
The Kid,2 wins.,0,2,0,2
The Perfect Storm,Nominated for 2 Oscars. Another 4 wins & 25 nominations.,2,4,25,31
Shadow of the Vampire,Nominated for 2 Oscars. Another 16 wins & 27 nominations.,2,16,27,45
Coyote Ugly,4 wins & 8 nominations.,0,4,8,12
Nine Queens,,0,0,0,0
Frequency,Nominated for 1 Golden Globe. Another 2 wins & 7 nominations.,0,2,8,10
Space Cowboys,Nominated for 1 Oscar. Another 4 wins & 8 nominations.,1,4,8,13
Shaft,2 wins & 13 nominations.,0,2,13,15
Final Destination,3 wins & 5 nominations,0,3,5,8
Bailando en la oscuridad,,0,0,0,0
Finding Forrester,5 wins & 13 nominations.,0,5,13,18
Bring It On,2 wins & 7 nominations.,0,2,7,9
Little Nicky,1 win & 12 nominations,0,1,12,13
Shanghai Noon,1 win & 7 nominations.,0,1,7,8
Leyenda urbana 2,,0,0,0,0
Bait,,0,0,0,0
The Skulls,1 nomination,0,0,1,1
Happy Accidents,1 win & 2 nominations.,0,1,2,3
Pay It Forward,1 win & 4 nominations,0,1,4,5
Bamboozled,1 win & 10 nominations.,0,1,10,11
Center Stage,1 win.,0,1,0,1
Brother,1 win & 2 nominations.,0,1,2,3
What Lies Beneath,7 wins & 7 nominations.,0,7,7,14
MVP: Most Valuable Primate,1 win & 2 nominations.,0,1,2,3
Pollock,Won 1 Oscar. 3 wins & 9 nominations total,1,3,9,13
Supernova,,0,0,0,0
X-Men,13 wins & 26 nominations.,0,13,26,39
28 Days,1 win.,0,1,0,1
Book of Shadows: Blair Witch 2,5 wins & 11 nominations.,0,5,11,16
"Crouching Tiger, Hidden Dragon",Won 4 Oscars. Another 98 wins & 134 nominations.,4,98,134,236
Bootmen,9 wins & 3 nominations.,0,9,3,12
Pok�mon 3: The Movie,,0,0,0,0
Lucky Numbers,2 wins & 1 nomination.,0,2,1,3
The Road to El Dorado,1 win & 12 nominations.,0,1,12,13
Cecil B. DeMented,2 nominations.,0,0,2,2
"Love, Honor and Obey",,0,0,0,0
Love's Labour's Lost,1 win & 2 nominations.,0,1,2,3
The House of Mirth,Nominated for 1 BAFTA Film Award. Another 6 wins & 28 nominations.,0,6,29,35
Tadpole,3 wins & 4 nominations.,0,3,4,7
Bounce,2 wins & 2 nominations.,0,2,2,4
Small Time Crooks,1 win & 4 nominations.,0,1,4,5
Loser,1 nomination.,0,0,1,1
Snatch,4 wins & 7 nominations.,0,4,7,11
Pitch Black,2 wins & 9 nominations,0,2,9,11
Lost Souls,2 nominations.,0,0,2,2
The Emperor's New Groove,Nominated for 1 Oscar. Another 7 wins & 26 nominations.,1,7,26,34
Love & Sex,2 wins & 1 nomination.,0,2,1,3
Vampire Hunter D: Bloodlust,,0,0,0,0
Whatever It Takes,3 nominations.,0,0,3,3
Boys and Girls,1 nomination.,0,0,1,1
About Adam,3 nominations.,0,0,3,3
Bread and Tulips,32 wins & 13 nominations.,0,32,13,45
The Replacements,,0,0,0,0
Sunset Strip,,0,0,0,0
Cast Away,Nominated for 2 Oscars. Another 15 wins & 36 nominations.,2,15,36,53
Songcatcher,5 wins & 5 nominations.,0,5,5,10
Mal�na,,0,0,0,0
Unbreakable,2 wins & 15 nominations,0,2,15,17
Beautiful,1 win.,0,1,0,1
Love & Basketball,2 wins & 1 nomination.,0,2,1,3
Nurse Betty,5 wins & 14 nominations,0,5,14,19
Nutty Professor II: The Klumps,2 wins & 15 nominations.,0,2,15,17
Vertical Limit,Nominated for 1 BAFTA Film Award. Another 2 wins & 3 nominations.,0,2,4,6
"O Brother, Where Art Thou?",Nominated for 2 Oscars. 7 wins & 39 nominations total,2,7,39,48
Digimon: The Movie,1 win.,0,1,0,1
The Tigger Movie,4 nominations.,0,0,4,4
Here on Earth,2 nominations.,0,0,2,2
Boiler Room,1 win & 9 nominations.,0,1,9,10
Vulgar,,0,0,0,0
Vatel,Nominated for 1 Oscar. Another 2 wins & 2 nominations.,1,2,2,5
The Dish,3 wins & 10 nominations,0,3,10,13
Battlefield Earth,19 wins & 3 nominations.,0,19,3,22
Waking the Dead,1 nomination.,0,0,1,1
Autumn in New York,3 nominations,0,0,3,3
The Specials,,0,0,0,0
The Broken Hearts Club: A Romantic Comedy,1 win & 1 nomination.,0,1,1,2
"Dude, Where's My Car?",6 nominations.,0,0,6,6
Erin Brockovich,Won 1 Oscar. Another 32 wins & 59 nominations.,1,32,59,92
The Way of the Gun,,0,0,0,0
Memento,Nominated for 2 Oscars. Another 57 wins & 57 nominations.,2,57,57,116
The Monkey's Mask,3 wins & 4 nominations,0,3,4,7
Dancing at the Blue Iguana,2 wins & 1 nomination.,0,2,1,3
Get Carter,7 nominations.,0,0,7,7
Dr. T & the Women,4 nominations.,0,0,4,4
American Psycho,8 wins & 13 nominations.,0,8,13,21
Dracula 2000,2 nominations.,0,0,2,2
The Legend of Bagger Vance,2 wins & 11 nominations.,0,2,11,13
The Million Dollar Hotel,2 wins & 5 nominations.,0,2,5,7
The Flintstones in Viva Rock Vegas,1 win & 11 nominations.,0,1,11,12
Road Trip,4 wins & 9 nominations.,0,4,9,13
The 6th Day,8 nominations,0,0,8,8
Scary Movie,7 wins & 6 nominations.,0,7,6,13
Committed,1 win & 2 nominations.,0,1,2,3
Men of Honor,11 nominations,0,0,11,11
The Crew,1 win.,0,1,0,1
The Next Best Thing,3 wins & 10 nominations.,0,3,10,13
Requiem for a Dream,Nominated for 1 Oscar. Another 38 wins & 69 nominations.,1,38,69,108
Down to You,1 win & 4 nominations.,0,1,4,5
I Dreamed of Africa,3 nominations.,0,0,3,3
State and Main,7 wins & 8 nominations,0,7,8,15
Thirteen Days,3 wins & 8 nominations.,0,3,8,11
Better Than Sex,1 win & 12 nominations.,0,1,12,13
My Dog Skip,7 wins & 4 nominations.,0,7,4,11
Return to Me,2 wins & 2 nominations.,0,2,2,4
Thomas and the Magic Railroad,2 nominations.,0,0,2,2
102 Dalmatians,Nominated for 1 Oscar. Another 1 win & 7 nominations.,1,1,7,9
Gossip,3 nominations,0,0,3,3
Traffic,Won 4 Oscars. Another 70 wins & 87 nominations.,4,70,87,161
Come Undone,1 nomination.,0,0,1,1
Dungeons & Dragons,11 nominations.,0,0,11,11
The Man Who Cried,3 wins & 3 nominations.,0,3,3,6
Girlfight,15 wins & 18 nominations,0,15,18,33
Rugrats in Paris: The Movie,3 wins & 7 nominations,0,3,7,10
Rules of Engagement,1 win & 2 nominations.,0,1,2,3
Duets,1 nomination.,0,0,1,1
Mission: Impossible II,12 wins & 20 nominations.,0,12,20,32
Drowning Mona,1 nomination.,0,0,1,1
Together,15 wins & 15 nominations.,0,15,15,30
Billy Elliot,Nominated for 3 Oscars. 56 wins & 73 nominations total,3,56,73,132
Chicken Run,Nominated for 1 BAFTA Film Award. Another 23 wins & 25 nominations.,0,23,26,49
Big Momma's House,1 win & 9 nominations.,0,1,9,10
In the Mood for Love,Nominated for 1 BAFTA Film Award. Another 46 wins & 50 nominations.,0,46,51,97
Keeping the Faith,2 wins & 6 nominations.,0,2,6,8
Highlander: Endgame,1 nomination,0,0,1,1
Amores Perros,Nominated for 1 Oscar. 55 wins & 25 nominations total,1,55,25,81
The Claim,1 win & 10 nominations.,0,1,10,11
Tigerland,2 wins & 5 nominations.,0,2,5,7
The Art of War,2 wins & 9 nominations.,0,2,9,11
The Contender,Nominated for 2 Oscars. Another 1 win & 20 nominations.,2,1,20,23
Miss Congeniality,Nominated for 2 Golden Globes. Another 7 wins & 6 nominations.,0,7,8,15
Mission to Mars,2 nominations.,0,0,2,2
High Fidelity,3 wins & 22 nominations total,0,3,22,25
Gone in Sixty Seconds,,0,0,0,0
The Little Vampire,1 win & 3 nominations.,0,1,3,4
Romeo Must Die,2 wins & 7 nominations,0,2,7,9
Timecode,2 nominations.,0,0,2,2
The Adventures of Rocky & Bullwinkle,2 wins & 6 nominations,0,2,6,8
Greenfingers,1 nomination,0,0,1,1
El asalto,,0,0,0,0
Best in Show,Nominated for 1 Golden Globe. Another 11 wins & 13 nominations.,0,11,14,25
The Family Man,4 wins & 6 nominations.,0,4,6,10
Meet the Parents,Nominated for 1 Oscar. Another 7 wins & 14 nominations.,1,7,14,22
Red Planet,1 nomination.,0,0,1,1
The Yards,3 wins & 2 nominations.,0,3,2,5
Bless the Child,1 win & 6 nominations,0,1,6,7
Antes que anochezca,,0,0,0,0
The Ladies Man,1 nomination.,0,0,1,1
Ready to Rumble,1 nomination.,0,0,1,1
"Me, Myself & Irene",2 wins & 4 nominations,0,2,4,6
Hollow Man,Nominated for 1 Oscar. Another 7 wins & 13 nominations.,1,7,13,21
Reindeer Games,3 nominations.,0,0,3,3
Maybe Baby,1 nomination.,0,0,1,1
Gun Shy,,0,0,0,0
Almost Famous,Won 1 Oscar. Another 52 wins & 103 nominations.,1,52,103,156
Woman on Top,3 nominations.,0,0,3,3
How the Grinch Stole Christmas,Won 1 Oscar. Another 17 wins & 37 nominations.,1,17,37,55
The Whole Nine Yards,6 nominations,0,0,6,6
Next Friday,2 nominations.,0,0,2,2
Charlie's Angels,15 wins & 33 nominations,0,15,33,48
The Weight of Water,1 win & 1 nomination.,0,1,1,2
All the Pretty Horses,2 wins & 14 nominations.,0,2,14,16
The Patriot,Nominated for 3 Oscars. 9 wins & 20 nominations total,3,9,20,32
Wonder Boys,Won 1 Oscar. 21 wins & 46 nominations total,1,21,46,68
The Beach,7 nominations.,0,0,7,7
Gangster No. 1,1 win & 9 nominations.,0,1,9,10
Titan A.E.,1 win & 6 nominations,0,1,6,7
Remember the Titans,8 wins & 18 nominations.,0,8,18,26
The Crimson Rivers,1 win & 6 nominations.,0,1,6,7
Scream 3,6 wins & 5 nominations,0,6,5,11
Screwed,,0,0,0,0
Animal Factory,1 nomination.,0,0,1,1
You Can Count on Me,Nominated for 2 Oscars. 30 wins & 43 nominations total,2,30,43,75
The Out-of-Towners,1 win.,0,1,0,1
Rosetta,9 wins & 7 nominations.,0,9,7,16
Sweet and Lowdown,Nominated for 2 Oscars. Another 1 win & 13 nominations.,2,1,13,16
Enredos de oficina,,0,0,0,0
Deep Blue Sea,2 wins & 4 nominations.,0,2,4,6
Being John Malkovich,Nominated for 3 Oscars. Another 48 wins & 76 nominations.,3,48,76,127
Election,Nominated for 1 Oscar. 16 wins & 34 nominations total,1,16,34,51
Jin-Roh: The Wolf Brigade,4 wins & 2 nominations.,0,4,2,6
The Green Mile,Nominated for 4 Oscars. Another 15 wins & 33 nominations.,4,15,33,52
Drive Me Crazy,1 win,0,1,0,1
Star Wars: Episode I - The Phantom Menace,Nominated for 3 Oscars. Another 26 wins & 66 nominations.,3,26,66,95
Pushing Tin,2 nominations,0,0,2,2
Random Hearts,,0,0,0,0
Breakfast of Champions,1 nomination.,0,0,1,1
8 � Women,,0,0,0,0
Romance,1 nomination.,0,0,1,1
Dick,4 nominations.,0,0,4,4
Kikujiro,4 wins & 4 nominations.,0,4,4,8
She's All That,8 wins & 5 nominations.,0,8,5,13
Dead or Alive,2 wins.,0,2,0,2
The Other Sister,2 nominations.,0,0,2,2
Julien Donkey-Boy,3 wins & 4 nominations.,0,3,4,7
Jakob the Liar,2 wins & 3 nominations.,0,2,3,5
Wild Wild West,15 wins & 17 nominations.,0,15,17,32
But I'm a Cheerleader,2 wins & 2 nominations.,0,2,2,4
Stigmata,6 nominations.,0,0,6,6
The King and I,Won 5 Oscars. Another 5 wins & 12 nominations.,5,5,12,22
The Love Letter,1 nomination.,0,0,1,1
Runaway Bride,6 wins & 10 nominations.,0,6,10,16
Entrapment,4 wins & 6 nominations.,0,4,6,10
Dudley Do-Right,1 nomination.,0,0,1,1
Jesus' Son,4 wins & 7 nominations.,0,4,7,11
"South Park: Bigger, Longer & Uncut",Nominated for 1 Oscar. Another 7 wins & 10 nominations.,1,7,10,18
Dogma,8 nominations,0,0,8,8
The Loss of Sexual Innocence,1 nomination.,0,0,1,1
El piso 13,,0,0,0,0
The General's Daughter,3 wins & 5 nominations,0,3,5,8
Drop Dead Gorgeous,2 wins & 2 nominations.,0,2,2,4
The Rage: Carrie 2,1 win & 3 nominations.,0,1,3,4
Stir of Echoes,3 wins & 5 nominations.,0,3,5,8
Payback,2 wins & 2 nominations.,0,2,2,4
Body Shots,,0,0,0,0
8MM,2 wins & 2 nominations,0,2,2,4
Rescate explosivo,,0,0,0,0
Wing Commander,,0,0,0,0
Big Daddy,8 wins & 14 nominations.,0,8,14,22
East Is East,Nominated for 4 BAFTA Film Awards. Another 16 wins & 10 nominations.,0,16,14,30
The Mummy,Nominated for 1 Oscar. Another 5 wins & 23 nominations.,1,5,23,29
Pok�mon: The Movie 2000,,0,0,0,0
Idle Hands,4 nominations.,0,0,4,4
Plunkett & Macleane,,0,0,0,0
Brokedown Palace,1 nomination,0,0,1,1
The End of the Affair,Nominated for 2 Oscars. 2 wins & 29 nominations total,2,2,29,33
Jawbreaker,1 nomination.,0,0,1,1
Ride with the Devil,1 nomination,0,0,1,1
End of Days,1 win & 7 nominations,0,1,7,8
Splendor,,0,0,0,0
Double Jeopardy,1 win & 3 nominations.,0,1,3,4
The Road Home,19 wins & 10 nominations.,0,19,10,29
Blue Streak,,0,0,0,0
Black & White,56 wins & 4 nominations.,0,56,4,60
The Omega Code,,0,0,0,0
The Mod Squad,7 nominations,0,0,7,7
The Insider,Nominated for 7 Oscars. Another 23 wins & 51 nominations.,7,23,51,81
Detroit Rock City,3 nominations.,0,0,3,3
Best Laid Plans,1 win.,0,1,0,1
Superstar,2 nominations.,0,0,2,2
Whiteboyz,2 nominations.,0,0,2,2
Cruel Intentions,8 wins & 14 nominations.,0,8,14,22
Better Than Chocolate,1 win & 1 nomination.,0,1,1,2
Deuce Bigalow: Male Gigolo,2 nominations.,0,0,2,2
The Minus Man,1 win & 4 nominations.,0,1,4,5
Simplemente irresistible,,0,0,0,0
Play It to the Bone,,0,0,0,0
The Girl on the Bridge,Nominated for 1 BAFTA Film Award. Another 6 wins & 17 nominations.,0,6,18,24
The Muse,Nominated for 1 Golden Globe. Another 2 nominations.,0,0,3,3
Snow Falling on Cedars,Nominated for 1 Oscar. Another 5 wins & 10 nominations.,1,5,10,16
The Limey,1 win & 9 nominations.,0,1,9,10
Bicentennial Man,Nominated for 1 Oscar. 2 wins & 8 nominations total,1,2,8,11
The Matrix,Won 4 Oscars. 42 wins & 51 nominations total,4,42,51,97
Human Traffic,9 wins & 7 nominations.,0,9,7,16
Blast from the Past,1 nomination.,0,0,1,1
Boys Don't Cry,Won 1 Oscar. 50 wins & 38 nominations total,1,50,38,89
Simpatico,1 nomination.,0,0,1,1
House on Haunted Hill,1 win & 4 nominations,0,1,4,5
The Iron Giant,20 wins & 18 nominations total,0,20,18,38
The Hurricane,Nominated for 1 Oscar. Another 7 wins & 17 nominations.,1,7,17,25
Eye of the Beholder,1 win.,0,1,0,1
"Stuart Little, un rat�n en la familia",,0,0,0,0
Summer of Sam,6 nominations.,0,0,6,6
Bowfinger,6 nominations.,0,0,6,6
Fantasia 2000,4 wins & 7 nominations.,0,4,7,11
Sleepy Hollow,Won 1 Oscar. 28 wins & 44 nominations total,1,28,44,73
Bats,,0,0,0,0
Eyes Wide Shut,12 wins & 30 nominations.,0,12,30,42
Edtv,2 nominations,0,0,2,2
The Messenger: The Story of Joan of Arc,5 wins & 13 nominations.,0,5,13,18
Bringing Out the Dead,2 wins & 5 nominations.,0,2,5,7
Holy Smoke,2 wins & 3 nominations.,0,2,3,5
eXistenZ: Mundo virtual,,0,0,0,0
The Deep End of the Ocean,3 wins & 2 nominations.,0,3,2,5
The Big Kahuna,1 nomination.,0,0,1,1
The Astronaut's Wife,1 nomination.,0,0,1,1
Varsity Blues,2 wins & 5 nominations.,0,2,5,7
The World Is Not Enough,7 wins & 12 nominations.,0,7,12,19
The Talented Mr. Ripley,Nominated for 5 Oscars. Another 10 wins & 76 nominations.,5,10,76,91
La maldici�n,,0,0,0,0
La �ltima puerta,,0,0,0,0
Galaxy Quest,7 wins & 14 nominations.,0,7,14,21
Gloria,Nominated for 1 Oscar. Another 4 wins & 4 nominations.,1,4,4,9
Lake Placid,,0,0,0,0
For Love of the Game,7 nominations.,0,0,7,7
The Wood,1 win & 7 nominations.,0,1,7,8
A Map of the World,Nominated for 1 Golden Globe. Another 3 wins & 5 nominations.,0,3,6,9
Titus,Nominated for 1 Oscar. Another 4 wins & 18 nominations.,1,4,18,23
True Crime,5 nominations.,0,0,5,5
The Thomas Crown Affair,3 wins & 2 nominations.,0,3,2,5
All About My Mother,Won 1 Oscar. 58 wins & 40 nominations total,1,58,40,99
"Girl, Interrupted",Won 1 Oscar. 8 wins & 11 nominations total,1,8,11,20
My Life So Far,,0,0,0,0
The Straight Story,Nominated for 1 Oscar. Another 18 wins & 39 nominations.,1,18,39,58
Agnes Browne,1 win & 2 nominations.,0,1,2,3
10 Things I Hate About You,2 wins & 13 nominations.,0,2,13,15
An Ideal Husband,Nominated for 2 Golden Globes. Another 4 wins & 15 nominations.,0,4,17,21
Onegin,3 wins & 4 nominations total,0,3,4,7
Cookie's Fortune,3 wins & 11 nominations.,0,3,11,14
Mystery Men,3 nominations.,0,0,3,3
Universal Soldier: The Return,,0,0,0,0
"Mystery, Alaska",1 nomination.,0,0,1,1
Mickey Blue Eyes,,0,0,0,0
Liberty Heights,2 nominations.,0,0,2,2
Terror Firmer,,0,0,0,0
Any Given Sunday,3 wins & 9 nominations.,0,3,9,12
The Cider House Rules,Won 2 Oscars. Another 6 wins & 30 nominations.,2,6,30,38
Love Stinks,,0,0,0,0
Arlington Road,5 nominations.,0,0,5,5
Molly,,0,0,0,0
Man on the Moon,Won 1 Golden Globe. Another 4 wins & 25 nominations.,0,5,25,30
Cradle Will Rock,5 wins & 7 nominations.,0,5,7,12
The Blair Witch Project,19 wins & 26 nominations.,0,19,26,45
Tarzan,Won 1 Oscar. Another 10 wins & 23 nominations.,1,10,23,34
Godzilla 2000,2 nominations.,0,0,2,2
200 Cigarettes,2 nominations.,0,0,2,2
The War Zone,9 wins & 12 nominations.,0,9,12,21
A Midsummer Night's Dream,1 win & 2 nominations.,0,1,2,3
Coming Soon,1 win & 6 nominations.,0,1,6,7
Teaching Mrs. Tingle,4 nominations.,0,0,4,4
Tea with Mussolini,Won 1 BAFTA Film Award. Another 4 wins & 3 nominations.,0,5,3,8
Topsy-Turvy,Won 2 Oscars. Another 11 wins & 28 nominations.,2,11,28,41
Notting Hill,Nominated for 1 BAFTA Film Award. Another 11 wins & 16 nominations.,0,11,17,28
Go,5 wins & 7 nominations.,0,5,7,12
Austin Powers: The Spy Who Shagged Me,Nominated for 1 Oscar. Another 18 wins & 30 nominations.,1,18,30,49
Toy Story 2,Nominated for 1 Oscar. Another 21 wins & 26 nominations.,1,21,26,48
Anywhere But Here,4 nominations.,0,0,4,4
The Winslow Boy,6 wins & 5 nominations.,0,6,5,11
The Bone Collector,1 win & 3 nominations.,0,1,3,4
Never Been Kissed,2 wins & 8 nominations.,0,2,8,10
In Too Deep,2 wins.,0,2,0,2
The Bachelor,1 win & 2 nominations.,0,1,2,3
October Sky,4 wins & 11 nominations.,0,4,11,15
The Color of Paradise,10 wins & 11 nominations.,0,10,11,21
Crazy in Alabama,5 wins & 6 nominations.,0,5,6,11
Forces of Nature,2 wins & 5 nominations.,0,2,5,7
Tumbleweeds,Nominated for 1 Oscar. Another 10 wins & 11 nominations.,1,10,11,22
At First Sight,,0,0,0,0
The Story of Us,1 win & 4 nominations.,0,1,4,5
Anna and the King,Nominated for 2 Oscars. Another 12 nominations.,2,0,12,14
Mumford,1 win & 1 nomination,0,1,1,2
Outside Providence,1 nomination.,0,0,1,1
Music of the Heart,Nominated for 2 Oscars. Another 5 wins & 9 nominations.,2,5,9,16
Three Kings,8 wins & 19 nominations.,0,8,19,27
Chill Factor,1 nomination.,0,0,1,1
Muppets from Space,1 nomination.,0,0,1,1
Inspector Gadget,1 win & 13 nominations.,0,1,13,14
Virtual Sexuality,,0,0,0,0
Trick,2 wins & 2 nominations.,0,2,2,4
Magnolia,Nominated for 3 Oscars. 28 wins & 59 nominations total,3,28,59,90
Instinct,1 win & 2 nominations.,0,1,2,3
Trippin',,0,0,0,0
Three to Tango,,0,0,0,0
Virus,,0,0,0,0
The Sixth Sense,Nominated for 6 Oscars. Another 37 wins & 50 nominations.,6,37,50,93
A Room for Romeo Brass,3 nominations.,0,0,3,3
The Corruptor,1 nomination,0,0,1,1
The Adventures of Elmo in Grouchland,1 win & 1 nomination.,0,1,1,2
Life,8 nominations,0,0,8,8
Grey Owl,1 win & 5 nominations,0,1,5,6
Swiri,8 wins & 4 nominations.,0,8,4,12
Fight Club,Nominated for 1 Oscar. 11 wins & 38 nominations total,1,11,38,50
American Beauty,Won 5 Oscars. Another 106 wins & 102 nominations.,5,106,102,213
Ghost dog - El camino del samurai,,0,0,0,0
"Happy, Texas",6 wins & 6 nominations.,0,6,6,12
Analyze This,4 wins & 7 nominations.,0,4,7,11
Mansfield Park,5 nominations,0,0,5,5
The Virgin Suicides,3 wins & 14 nominations.,0,3,14,17
A Walk on the Moon,1 win & 6 nominations.,0,1,6,7
My Favorite Martian,3 nominations.,0,0,3,3
The 13th Warrior,2 wins & 2 nominations.,0,2,2,4
Message in a Bottle,6 nominations,0,0,6,6
Angela's Ashes,Nominated for 1 Oscar. Another 5 wins & 11 nominations.,1,5,11,17
The Boondock Saints,,0,0,0,0
American Pie,9 wins & 14 nominations.,0,9,14,23
In Dreams,1 win.,0,1,0,1
The Best Man,8 wins & 11 nominations.,0,8,11,19
Baby Geniuses,2 wins & 3 nominations.,0,2,3,5
Thursday,1 win & 1 nomination.,0,1,1,2
The Faculty,11 nominations.,0,0,11,11
The Celebration,Nominated for 1 BAFTA Film Award. Another 28 wins & 22 nominations.,0,28,23,51
Gods and Monsters,Won 1 Oscar. Another 37 wins & 33 nominations.,1,37,33,71
I Want You,2 wins & 2 nominations.,0,2,2,4
Your Friends & Neighbors,2 wins & 4 nominations.,0,2,4,6
The Players Club,1 win.,0,1,0,1
Lovers of the Arctic Circle,14 wins & 8 nominations.,0,14,8,22
Apt Pupil,6 wins & 10 nominations.,0,6,10,16
Slappy and the Stinkers,1 win,0,1,0,1
How Stella Got Her Groove Back,4 wins & 8 nominations.,0,4,8,12
The Wedding Singer,5 wins & 7 nominations.,0,5,7,12
Acusado sin raz�n,,0,0,0,0
The Parent Trap,2 wins & 7 nominations,0,2,7,9
Hard Rain,,0,0,0,0
Free Enterprise,5 wins & 2 nominations.,0,5,2,7
Mafia!,2 nominations.,0,0,2,2
Desperate Measures,1 win.,0,1,0,1
The Big Lebowski,5 wins & 18 nominations,0,5,18,23
Cousin Bette,1 win & 1 nomination.,0,1,1,2
The Waterboy,6 wins & 6 nominations.,0,6,6,12
Esc�ndalo,,0,0,0,0
I Still Know What You Did Last Summer,5 wins & 7 nominations,0,5,7,12
Rush Hour,6 wins & 9 nominations,0,6,9,15
I'll Be Home for Christmas,,0,0,0,0
Why Do Fools Fall in Love,2 wins & 4 nominations.,0,2,4,6
Dance with Me,5 nominations.,0,0,5,5
Can't Hardly Wait,2 nominations.,0,0,2,2
Rounders,1 win & 1 nomination.,0,1,1,2
Urban Legend,1 win & 2 nominations.,0,1,2,3
Wide Awake,2 nominations.,0,0,2,2
Chairman of the Board,3 nominations.,0,0,3,3
Armageddon,Nominated for 4 Oscars. Another 15 wins & 36 nominations.,4,15,36,55
The Mask of Zorro,Nominated for 2 Oscars. Another 9 wins & 16 nominations.,2,9,16,27
My Name Is Joe,13 wins & 11 nominations.,0,13,11,24
Rushmore,16 wins & 16 nominations,0,16,16,32
Waking Ned Devine,,0,0,0,0
Shakespeare in Love,Won 7 Oscars. Another 57 wins & 87 nominations.,7,57,87,151
Hilary and Jackie,Nominated for 2 Oscars. Another 4 wins & 22 nominations.,2,4,22,28
The Impostors,1 nomination.,0,0,1,1
The Newton Boys,,0,0,0,0
El secreto,,0,0,0,0
Dancing at Lughnasa,2 wins & 7 nominations.,0,2,7,9
Still Crazy,2 wins & 5 nominations.,0,2,5,7
The Land Girls,,0,0,0,0
The Opposite of Sex,Nominated for 1 Golden Globe. Another 14 wins & 23 nominations.,0,14,24,38
The Magic Sword: Quest for Camelot,,0,0,0,0
Zero Effect,1 nomination.,0,0,1,1
Strangeland,1 nomination.,0,0,1,1
West Beirut,8 wins & 2 nominations.,0,8,2,10
Ride,,0,0,0,0
Six Days Seven Nights,2 wins & 5 nominations,0,2,5,7
The Man in the Iron Mask,3 wins & 4 nominations.,0,3,4,7
Wild Things,2 wins & 4 nominations.,0,2,4,6
The X Files,7 wins & 11 nominations.,0,7,11,18
Air Bud: Golden Receiver,4 nominations.,0,0,4,4
Another Day in Paradise,3 wins & 1 nomination.,0,3,1,4
Blues Brothers 2000,4 nominations.,0,0,4,4
The Odd Couple II,1 nomination.,0,0,1,1
Elizabeth,Won 1 Oscar. Another 33 wins & 55 nominations.,1,33,55,89
Almost Heroes,,0,0,0,0
The Object of My Affection,1 win & 1 nomination,0,1,1,2
The Big Hit,,0,0,0,0
You've Got Mail,6 wins & 8 nominations.,0,6,8,14
Simon Birch,3 wins & 3 nominations,0,3,3,6
A Civil Action,Nominated for 2 Oscars. Another 5 wins & 8 nominations.,2,5,8,15
Major League: Back to the Minors,1 win.,0,1,0,1
Run Lola Run,Nominated for 1 BAFTA Film Award. Another 28 wins & 20 nominations.,0,28,21,49
New Rose Hotel,2 wins & 2 nominations.,0,2,2,4
The Mighty,Nominated for 2 Golden Globes. Another 3 wins & 2 nominations.,0,3,4,7
There's Something About Mary,Nominated for 2 Golden Globes. Another 17 wins & 15 nominations.,0,17,17,34
Rudolph the Red-Nosed Reindeer,,0,0,0,0
Un �ngel enamorado,,0,0,0,0
Dangerous Beauty,2 nominations.,0,0,2,2
Mulan,Nominated for 1 Oscar. Another 17 wins & 20 nominations.,1,17,20,38
Madeline,5 nominations.,0,0,5,5
Enemy of the State,5 wins & 16 nominations.,0,5,16,21
He Got Game,10 nominations.,0,0,10,10
Ronin,1 win & 4 nominations.,0,1,4,5
Senseless,,0,0,0,0
Buffalo '66,6 wins & 11 nominations.,0,6,11,17
Get Real,6 wins & 3 nominations,0,6,3,9
Star Trek: Insurrection,3 wins & 8 nominations.,0,3,8,11
Antz,Nominated for 1 BAFTA Film Award. Another 6 wins & 13 nominations.,0,6,14,20
Ringmaster,1 win.,0,1,0,1
Belly,1 nomination.,0,0,1,1
Six-String Samurai,2 wins & 2 nominations.,0,2,2,4
Beloved,Nominated for 1 Oscar. 3 wins & 24 nominations total,1,3,24,28
Return to Paradise,2 nominations.,0,0,2,2
My Giant,,0,0,0,0
What Dreams May Come,Won 1 Oscar. Another 6 wins & 2 nominations.,1,6,2,9
Sliding Doors,6 wins & 4 nominations.,0,6,4,10
U.S. Marshals,1 nomination.,0,0,1,1
Meet Joe Black,3 wins & 6 nominations.,0,3,6,9
Playing by Heart,1 win & 1 nomination.,0,1,1,2
Saving Private Ryan,Won 5 Oscars. Another 74 wins & 75 nominations.,5,74,75,154
Halloween H20: 20 Years Later,2 wins & 12 nominations,0,2,12,14
Savior,2 wins.,0,2,0,2
Species II,1 nomination.,0,0,1,1
The Legend of 1900,Won 1 Golden Globe. Another 21 wins & 10 nominations.,0,22,10,32
Knock Off,,0,0,0,0
The Rugrats Movie,2 wins & 6 nominations.,0,2,6,8
Very Bad Things,2 wins & 3 nominations.,0,2,3,5
Barney's Great Adventure,5 nominations.,0,0,5,5
Jack Frost,1 nomination.,0,0,1,1
Fallen,3 nominations.,0,0,3,3
Pleasantville,Nominated for 3 Oscars. 18 wins & 45 nominations total,3,18,45,66
Following,5 wins & 4 nominations.,0,5,4,9
Twice Upon a Yesterday,3 wins & 5 nominations.,0,3,5,8
Mighty Joe Young,Nominated for 1 Oscar. 1 win & 4 nominations total,1,1,4,6
Train of Life,10 wins & 4 nominations.,0,10,4,14
B. Monkey,,0,0,0,0
A Night at the Roxbury,,0,0,0,0
Hush,2 wins & 7 nominations.,0,2,7,9
BASEketball,2 nominations.,0,0,2,2
Velvet Goldmine,Nominated for 1 Oscar. Another 4 wins & 11 nominations.,1,4,11,16
Deep Rising,2 nominations.,0,0,2,2
Hideous Kinky,1 win.,0,1,0,1
One True Thing,Nominated for 1 Oscar. Another 7 nominations.,1,0,7,8
Pok�mon: The First Movie - Mewtwo Strikes Back,,0,0,0,0
Babe el puerquito va a la ciudad,,0,0,0,0
Deep Impact,5 wins & 14 nominations.,0,5,14,19
54,9 nominations.,0,0,9,9
Out of Sight,Nominated for 2 Oscars. Another 13 wins & 13 nominations.,2,13,13,28
Bride of Chucky,5 wins & 7 nominations,0,5,7,12
Pi,8 wins & 12 nominations.,0,8,12,20
Woo,,0,0,0,0
Hope Floats,3 wins & 9 nominations.,0,3,9,12
Sour Grapes,2 wins,0,2,0,2
Pecker,2 wins & 1 nomination.,0,2,1,3
Firestorm,,0,0,0,0
American History X,Nominated for 1 Oscar. 4 wins & 15 nominations total,1,4,15,20
Paulie,2 wins & 6 nominations.,0,2,6,8
Ciudad en tinieblas,,0,0,0,0
The Last Days of Disco,1 win & 1 nomination,0,1,1,2
Patch Adams,Nominated for 1 Oscar. Another 1 win & 7 nominations.,1,1,7,9
Bulworth,Nominated for 1 Oscar. 1 win & 20 nominations total,1,1,20,22
All I Wanna Do,,0,0,0,0
Xiu Xiu: The Sent-Down Girl,12 wins & 13 nominations.,0,12,13,25
The Siege,2 wins & 4 nominations.,0,2,4,6
Fear and Loathing in Las Vegas,1 win & 3 nominations.,0,1,3,4
Doctor Dolittle,4 wins & 10 nominations.,0,4,10,14
The Gingerbread Man,,0,0,0,0
Mercury Rising,2 wins.,0,2,0,2
The Dinner Game,,0,0,0,0
Half Baked,,0,0,0,0
Phantoms,2 nominations.,0,0,2,2
"Lock, Stock and Two Smoking Barrels",Nominated for 1 BAFTA Film Award. Another 13 wins & 8 nominations.,0,13,9,22
Krippendorf's Tribe,1 nomination.,0,0,1,1
Meet the Deedles,1 win & 2 nominations.,0,1,2,3
Little Voice,Nominated for 1 Oscar. Another 2 wins & 29 nominations.,1,2,29,32
Without Limits,Nominated for 1 Golden Globe. Another 1 win & 1 nomination.,0,1,2,3
Perturbados,,0,0,0,0
Blade,5 wins & 11 nominations.,0,5,11,16
Permanent Midnight,1 nomination.,0,0,1,1
Black Dog,,0,0,0,0
Celebrity,4 nominations.,0,0,4,4
3 Ninjas: High Noon at Mega Mountain,2 nominations.,0,0,2,2
Central Station,Nominated for 2 Oscars. Another 43 wins & 24 nominations.,2,43,24,69
The General,2 wins & 1 nomination.,0,2,1,3
Vampires,7 wins & 6 nominations.,0,7,6,13
Tarzan and the Lost City,1 nomination.,0,0,1,1
Safe Men,,0,0,0,0
The Horse Whisperer,Nominated for 1 Oscar. Another 4 wins & 18 nominations.,1,4,18,23
Snake Eyes,1 win & 4 nominations.,0,1,4,5
Psycho,Nominated for 4 Oscars. Another 8 wins & 10 nominations.,4,8,10,22
A Perfect Murder,2 wins & 3 nominations.,0,2,3,5
Slums of Beverly Hills,9 nominations.,0,0,9,9
Small Soldiers,3 wins & 4 nominations,0,3,4,7
Immortality,3 wins & 3 nominations.,0,3,3,6
Sphere,3 nominations,0,0,3,3
The Prince of Egypt,Won 1 Oscar. 12 wins & 27 nominations total,1,12,27,40
Lethal Weapon 4,4 wins & 11 nominations,0,4,11,15
Smoke Signals,12 wins & 8 nominations.,0,12,8,20
A Bug's Life,Nominated for 1 Oscar. Another 14 wins & 20 nominations.,1,14,20,35
Home Fries,,0,0,0,0
The Truman Show,Nominated for 3 Oscars. Another 40 wins & 66 nominations.,3,40,66,109
Ever After: A Cinderella Story,6 wins & 15 nominations.,0,6,15,21
Goodbye Lover,2 nominations.,0,0,2,2
Los idiotas,,0,0,0,0
"Black Cat, White Cat",5 wins & 5 nominations,0,5,5,10
The Replacement Killers,1 nomination.,0,0,1,1
Holy Man,1 nomination.,0,0,1,1
Dead Man on Campus,,0,0,0,0
Hurlyburly,1 win & 3 nominations.,0,1,3,4
Soldier,1 nomination.,0,0,1,1
The Thin Red Line,Nominated for 7 Oscars. 21 wins & 47 nominations total,7,21,47,75
Clay Pigeons,1 nomination.,0,0,1,1
Stepmom,8 wins & 7 nominations,0,8,7,15
Practical Magic,1 win & 6 nominations,0,1,6,7
A Simple Plan,Nominated for 2 Oscars. Another 16 wins & 22 nominations.,2,16,22,40
High Art,7 wins & 18 nominations.,0,7,18,25
The Red Violin,Won 1 Oscar. Another 19 wins & 19 nominations.,1,19,19,39
The Hi-Lo Country,4 wins & 4 nominations.,0,4,4,8
SLC Punk!,2 wins & 6 nominations.,0,2,6,8
Kissing a Fool,1 nomination.,0,0,1,1
Homegrown,,0,0,0,0
Dirty Work,,0,0,0,0
'Til There Was You,1 nomination.,0,0,1,1
Gridlock'd,2 wins & 1 nomination.,0,2,1,3
An Alan Smithee Film: Burn Hollywood Burn,6 wins & 8 nominations.,0,6,8,14
Mr. Jealousy,,0,0,0,0
RocketMan,Won 1 Oscar. Another 20 wins & 78 nominations.,1,20,78,99
Alien Resurrection,7 wins & 21 nominations.,0,7,21,28
Scream 2,8 wins & 13 nominations.,0,8,13,21
Liar Liar,4 wins & 6 nominations.,0,4,6,10
Mousehunt,2 wins & 2 nominations.,0,2,2,4
McHale's Navy,2 wins & 2 nominations.,0,2,2,4
Zeus and Roxanne,,0,0,0,0
Men in Black,Won 1 Oscar. Another 21 wins & 39 nominations.,1,21,39,61
The Full Monty,Won 1 Oscar. 37 wins & 35 nominations total,1,37,35,73
The Jackal,1 win & 4 nominations.,0,1,4,5
Starship Troopers,Nominated for 1 Oscar. Another 3 wins & 15 nominations.,1,3,15,19
Welcome to Sarajevo,1 win & 2 nominations.,0,1,2,3
Digging to China,2 wins.,0,2,0,2
Trojan War,,0,0,0,0
Mr. Magoo,2 nominations.,0,0,2,2
Anaconda,6 wins & 11 nominations.,0,6,11,17
Trial and Error,,0,0,0,0
The Manson Family,1 nomination.,0,0,1,1
Two Girls and a Guy,,0,0,0,0
Inventing the Abbotts,,0,0,0,0
Ulee's Gold,Nominated for 1 Oscar. Another 8 wins & 16 nominations.,1,8,16,25
Grosse Pointe Blank,2 wins & 8 nominations.,0,2,8,10
Good Burger,,0,0,0,0
Amy Foster,,0,0,0,0
Wishmaster,3 nominations.,0,0,3,3
Dante's Peak,4 wins & 1 nomination.,0,4,1,5
Mortal Kombat: Annihilation,,0,0,0,0
Good Will Hunting,Won 2 Oscars. Another 22 wins & 61 nominations.,2,22,61,85
Amistad,Nominated for 4 Oscars. Another 11 wins & 39 nominations.,4,11,39,54
Steel,1 nomination.,0,0,1,1
Mimic,3 wins & 8 nominations.,0,3,8,11
Titanic,Won 11 Oscars. Another 115 wins & 83 nominations.,11,115,83,209
Dulce porvenir,,0,0,0,0
The Castle,2 wins & 11 nominations.,0,2,11,13
Con Air,Nominated for 2 Oscars. Another 7 wins & 9 nominations.,2,7,9,18
The Assignment,,0,0,0,0
Midnight in the Garden of Good and Evil,1 win & 4 nominations.,0,1,4,5
An American Werewolf in Paris,3 wins & 1 nomination.,0,3,1,4
Still Breathing,1 win & 1 nomination.,0,1,1,2
Gone Fishin',1 nomination.,0,0,1,1
Most Wanted,1 win & 1 nomination.,0,1,1,2
The Game,1 nomination.,0,0,1,1
Jungle 2 Jungle,3 nominations.,0,0,3,3
Tomorrow Never Dies,6 wins & 10 nominations,0,6,10,16
Lawn Dogs,7 wins & 4 nominations.,0,7,4,11
Romy and Michele's High School Reunion,4 nominations.,0,0,4,4
Clockwatchers,2 wins & 1 nomination.,0,2,1,3
A Simple Wish,1 win & 2 nominations.,0,1,2,3
Washington Square,1 nomination.,0,0,1,1
Children of Heaven,,0,0,0,0
Buddy,6 wins & 6 nominations.,0,6,6,12
The Last Time I Committed Suicide,,0,0,0,0
The Apostle,Nominated for 1 Oscar. Another 13 wins & 7 nominations.,1,13,7,21
Metro,1 nomination,0,0,1,1
The Man Who Knew Too Little,,0,0,0,0
The Lost World: Jurassic Park,Nominated for 1 Oscar. 4 wins & 28 nominations total,1,4,28,33
Going All the Way,1 win & 2 nominations.,0,1,2,3
Rosewood,3 wins & 10 nominations.,0,3,10,13
Shooting Fish,3 wins.,0,3,0,3
I Know What You Did Last Summer,3 wins & 7 nominations.,0,3,7,10
Money Talks,1 nomination.,0,0,1,1
The Boxer,Nominated for 3 Golden Globes. Another 3 wins & 3 nominations.,0,3,6,9
Mr. Nice Guy,,0,0,0,0
Nothing to Lose,1 win.,0,1,0,1
Breakdown,1 win & 2 nominations.,0,1,2,3
Fools Rush In,3 nominations.,0,0,3,3
Por el lado oscuro del camino,,0,0,0,0
Face/Off,Nominated for 1 Oscar. Another 11 wins & 21 nominations.,1,11,21,33
B*A*P*S,2 nominations.,0,0,2,2
FairyTale: A True Story,1 win & 3 nominations.,0,1,3,4
Vegas Vacation,1 nomination.,0,0,1,1
One Eight Seven,1 win & 1 nomination.,0,1,1,2
One Night Stand,1 win & 3 nominations.,0,1,3,4
Flubber,3 wins & 2 nominations.,0,3,2,5
Plump Fiction,,0,0,0,0
Batman & Robin,Won 1 Oscar. Another 8 wins & 26 nominations.,1,8,26,35
A Thousand Acres,Nominated for 1 Golden Globe. Another 2 wins.,0,2,1,3
Open Your Eyes,6 wins & 14 nominations.,0,6,14,20
Playing God,,0,0,0,0
Breaking Up,,0,0,0,0
The Relic,4 nominations.,0,0,4,4
Speed 2: Cruise Control,1 win & 9 nominations.,0,1,9,10
Star Maps,1 win & 7 nominations.,0,1,7,8
Henry Fool,1 win & 1 nomination.,0,1,1,2
Smilla's Sense of Snow,1 nomination,0,0,1,1
Spice World,3 wins & 11 nominations.,0,3,11,14
Private Parts,2 wins & 3 nominations.,0,2,3,5
Nowhere,1 nomination.,0,0,1,1
Princess Mononoke,,0,0,0,0
Kiss the Girls,5 nominations.,0,0,5,5
Star Kid,,0,0,0,0
Excess Baggage,2 wins & 3 nominations.,0,2,3,5
Prefontaine,,0,0,0,0
Wag the Dog,Nominated for 2 Oscars. Another 2 wins & 21 nominations.,2,2,21,25
The Rainmaker,2 wins & 10 nominations,0,2,10,12
Bean,2 wins & 1 nomination,0,2,1,3
The Real Blonde,,0,0,0,0
Austin Powers: International Man of Mystery,3 wins & 8 nominations.,0,3,8,11
For Richer or Poorer,1 nomination.,0,0,1,1
Seven Years in Tibet,Nominated for 1 Golden Globe. Another 3 wins & 7 nominations.,0,3,8,11
Orgazmo,,0,0,0,0
Oscar and Lucinda,Nominated for 1 Oscar. Another 10 wins & 6 nominations.,1,10,6,17
The Sixth Man,,0,0,0,0
Switchback,,0,0,0,0
Firelight,2 wins & 2 nominations.,0,2,2,4
In & Out,Won 2 Oscars. Another 135 wins & 373 nominations.,2,135,373,510
Paradise Road,1 win & 7 nominations.,0,1,7,8
Kull the Conqueror,,0,0,0,0
Fire Down Below,1 win & 5 nominations.,0,1,5,6
Kundun,Nominated for 4 Oscars. Another 7 wins & 9 nominations.,4,7,9,20
Fathers' Day,1 nomination.,0,0,1,1
L.A. Confidential,Won 2 Oscars. Another 89 wins & 85 nominations.,2,89,85,176
The Beautician and the Beast,1 nomination.,0,0,1,1
Volcano,1 win & 1 nomination.,0,1,1,2
City of Industry,1 nomination.,0,0,1,1
Fierce Creatures,,0,0,0,0
Perfect Blue,3 wins & 3 nominations.,0,3,3,6
The End of Violence,1 win & 4 nominations.,0,1,4,5
Picture Perfect,,0,0,0,0
Cats Don't Dance,3 wins & 13 nominations.,0,3,13,16
The Devil's Advocate,2 wins & 7 nominations.,0,2,7,9
Lolita,Nominated for 1 Oscar. Another 2 wins & 8 nominations.,1,2,8,11
Deconstructing Harry,Nominated for 1 Oscar. Another 4 wins & 5 nominations.,1,4,5,10
Hoodlum,7 nominations,0,0,7,7
The Devil's Own,1 nomination.,0,0,1,1
The Saint,1 win & 2 nominations.,0,1,2,3
Spawn,2 wins & 6 nominations.,0,2,6,8
Out to Sea,,0,0,0,0
Deceiver,3 wins.,0,3,0,3
The Borrowers,Nominated for 1 BAFTA Film Award. Another 1 win & 3 nominations.,0,1,4,5
Soul Food,6 wins & 11 nominations.,0,6,11,17
Live Flesh,Nominated for 1 BAFTA Film Award. Another 11 wins & 13 nominations.,0,11,14,25
The Edge,3 nominations.,0,0,3,3
The Spanish Prisoner,3 nominations.,0,0,3,3
Anastasia,Nominated for 2 Oscars. 10 wins & 23 nominations total,2,10,23,35
8 Heads in a Duffel Bag,1 win.,0,1,0,1
Event Horizon,1 win & 2 nominations.,0,1,2,3
Gummo,4 wins & 2 nominations.,0,4,2,6
Conspiracy Theory,4 wins & 1 nomination.,0,4,1,5
Mad City,1 nomination.,0,0,1,1
Chasing Amy,Nominated for 1 Golden Globe. Another 5 wins & 15 nominations.,0,5,16,21
Sin embargo es adorable,,0,0,0,0
Gattaca,Nominated for 1 Oscar. Another 6 wins & 15 nominations.,1,6,15,22
That Darn Cat,2 nominations.,0,0,2,2
Contact,Nominated for 1 Oscar. Another 14 wins & 30 nominations.,1,14,30,45
Ma Vie en Rose,Won 1 Golden Globe. Another 12 wins & 7 nominations.,0,13,7,20
The Night Flier,1 win & 2 nominations.,0,1,2,3
The Fifth Element,Nominated for 1 Oscar. Another 10 wins & 38 nominations.,1,10,38,49
Boogie Nights,Nominated for 3 Oscars. 36 wins & 64 nominations total,3,36,64,103
Wilde,Nominated for 1 Golden Globe. Another 4 wins & 7 nominations.,0,4,8,12
George of the Jungle,1 win & 3 nominations.,0,1,3,4
The Butcher Boy,10 wins & 11 nominations.,0,10,11,21
Beverly Hills Ninja,1 nomination.,0,0,1,1
The MatchMaker,,0,0,0,0
Dangerous Ground,,0,0,0,0
Warriors of Virtue,2 nominations.,0,0,2,2
Mrs Brown,Nominated for 2 Oscars. Another 12 wins & 24 nominations.,2,12,24,38
Mrs Dalloway,2 wins & 1 nomination.,0,2,1,3
Selena,8 wins & 6 nominations,0,8,6,14
In the Company of Men,14 wins & 12 nominations.,0,14,12,26
"Truth or Consequences, N.M.",,0,0,0,0
Donnie Brasco,Nominated for 1 Oscar. Another 2 wins & 15 nominations.,1,2,15,18
Air Force One,Nominated for 2 Oscars. Another 7 wins & 11 nominations.,2,7,11,20
Eight Days a Week,3 wins.,0,3,0,3
Life Is Beautiful,1 win & 2 nominations.,0,1,2,3
Murder at 1600,,0,0,0,0
Air Bud,4 wins & 3 nominations.,0,4,3,7
The Ice Storm,Won 1 BAFTA Film Award. Another 5 wins & 33 nominations.,0,6,33,39
My Best Friend's Wedding,Nominated for 1 Oscar. Another 12 wins & 23 nominations.,1,12,23,36
Shadow Conspiracy,,0,0,0,0
Bent,3 wins & 3 nominations.,0,3,3,6
Affliction,Won 1 Oscar. Another 7 wins & 19 nominations.,1,7,19,27
Bliss,1 win & 1 nomination.,0,1,1,2
Turbo: A Power Rangers Movie,1 nomination.,0,0,1,1
Suicide Kings,,0,0,0,0
Character,Won 1 Oscar. Another 17 wins & 7 nominations.,1,17,7,25
Nightwatch,2 wins.,0,2,0,2
The Pest,1 nomination.,0,0,1,1
Absolute Power,1 nomination,0,0,1,1
Free Willy 3: The Rescue,2 wins & 2 nominations.,0,2,2,4
The House of Yes,1 win & 6 nominations.,0,1,6,7
Turbulence,4 nominations.,0,0,4,4
As Good as It Gets,Won 2 Oscars. Another 36 wins & 54 nominations.,2,36,54,92
The Postman,7 wins & 7 nominations.,0,7,7,14
Love Jones,2 wins & 7 nominations.,0,2,7,9
Eve's Bayou,12 wins & 17 nominations.,0,12,17,29
Home Alone 3,3 nominations.,0,0,3,3
A Smile Like Yours,1 nomination.,0,0,1,1
A Life Less Ordinary,1 win & 3 nominations.,0,1,3,4
The Peacemaker,2 nominations.,0,0,2,2
Cop Land,1 win & 1 nomination,0,1,1,2
Addicted to Love,1 nomination.,0,0,1,1
Jackie Brown,Nominated for 1 Oscar. Another 8 wins & 23 nominations.,1,8,23,32
Red Corner,4 wins.,0,4,0,4
Gang Related,,0,0,0,0
How to Be a Player,,0,0,0,0
Double Team,4 wins,0,4,0,4
G.I. Jane,2 wins & 3 nominations.,0,2,3,5
Booty Call,,0,0,0,0
The Wings of the Dove,Nominated for 4 Oscars. Another 16 wins & 28 nominations.,4,16,28,48
Wild America,1 win.,0,1,0,1
Camino sin retorno,,0,0,0,0
Shall We Dance?,55 wins & 7 nominations.,0,55,7,62
Twister,Nominated for 2 Oscars. 11 wins & 17 nominations total,2,11,17,30
Bloodsport 2,,0,0,0,0
Mars Attacks!,3 wins & 19 nominations.,0,3,19,22
The Juror,1 win & 2 nominations.,0,1,2,3
All Dogs Go to Heaven 2,3 nominations.,0,0,3,3
The Great White Hype,,0,0,0,0
Jude,5 wins & 6 nominations.,0,5,6,11
Two If by Sea,,0,0,0,0
Bottle Rocket,2 wins & 1 nomination.,0,2,1,3
Joe's Apartment,2 wins.,0,2,0,2
A Summer's Tale,1 nomination.,0,0,1,1
Sling Blade,Won 1 Oscar. Another 13 wins & 15 nominations.,1,13,15,29
Bound,8 wins & 13 nominations.,0,8,13,21
Box of Moon Light,,0,0,0,0
Love Is All There Is,,0,0,0,0
Boys,9 wins & 8 nominations.,0,9,8,17
Citizen Ruth,3 wins & 2 nominations.,0,3,2,5
City Hall,1 nomination.,0,0,1,1
Hellraiser: Bloodline,1 win & 2 nominations.,0,1,2,3
Brassed Off,Nominated for 1 BAFTA Film Award. Another 10 wins & 6 nominations.,0,10,7,17
Solo,,0,0,0,0
A Thin Line Between Love and Hate,,0,0,0,0
Some Mother's Son,4 wins & 1 nomination.,0,4,1,5
Lone Star,Nominated for 1 Oscar. Another 15 wins & 18 nominations.,1,15,18,34
Jingle All the Way,2 wins & 4 nominations.,0,2,4,6
Heaven's Prisoners,1 nomination.,0,0,1,1
Claroscuro,,0,0,0,0
Jerry Maguire,Won 1 Oscar. Another 25 wins & 41 nominations.,1,25,41,67
A Very Brady Sequel,2 nominations.,0,0,2,2
A Time to Kill,7 wins & 12 nominations.,0,7,12,19
Space Jam,5 wins & 7 nominations,0,5,7,12
Waiting for Guffman,2 wins & 3 nominations,0,2,3,5
The Birdcage,Nominated for 1 Oscar. Another 7 wins & 24 nominations.,1,7,24,32
Sleepers,Nominated for 1 Oscar. Another 1 win & 4 nominations.,1,1,4,6
Alaska,3 nominations.,0,0,3,3
I Shot Andy Warhol,5 wins & 7 nominations.,0,5,7,12
Two Much,5 nominations,0,0,5,5
Manny & Lo,2 nominations.,0,0,2,2
The Island of Dr. Moreau,2 wins & 10 nominations.,0,2,10,12
She's the One,3 nominations.,0,0,3,3
Shiloh,4 wins.,0,4,0,4
Albino Alligator,1 nomination.,0,0,1,1
Happy Gilmore,1 win & 4 nominations.,0,1,4,5
Head Above Water,1 win & 1 nomination.,0,1,1,2
The Cable Guy,3 wins & 2 nominations.,0,3,2,5
Hard Eight,2 wins & 8 nominations.,0,2,8,10
Spy Hard,,0,0,0,0
Bogus,1 win & 3 nominations.,0,1,3,4
Harriet the Spy,3 wins & 2 nominations.,0,3,2,5
Mad Dog Time,,0,0,0,0
Diabolique,2 wins & 1 nomination.,0,2,1,3
Broken Arrow,1 win & 3 nominations.,0,1,3,4
Bordello of Blood,,0,0,0,0
The Hunchback of Notre Dame,Nominated for 1 Oscar. 8 wins & 26 nominations total,1,8,26,35
Marvin's Room,Nominated for 1 Oscar. Another 4 wins & 12 nominations.,1,4,12,17
Swingers,3 wins & 3 nominations.,0,3,3,6
Mary Reilly,6 nominations.,0,0,6,6
The Trigger Effect,,0,0,0,0
Courage Under Fire,9 wins & 7 nominations.,0,9,7,16
The People vs. Larry Flynt,Nominated for 2 Oscars. Another 22 wins & 33 nominations.,2,22,33,57
Before and After,,0,0,0,0
The Phantom,3 wins.,0,3,0,3
Escape from L.A.,3 nominations,0,0,3,3
Freeway,6 wins & 4 nominations.,0,6,4,10
Chain Reaction,1 nomination.,0,0,1,1
Kingpin,,0,0,0,0
The Portrait of a Lady,Nominated for 2 Oscars. Another 5 wins & 13 nominations.,2,5,13,20
The Van,1 nomination.,0,0,1,1
The Preacher's Wife,Nominated for 1 Oscar. Another 4 wins & 6 nominations.,1,4,6,11
Bed of Roses,,0,0,0,0
Foxfire,,0,0,0,0
Beavis and Butt-Head Do America,1 win & 4 nominations.,0,1,4,5
Beautiful Thing,4 wins & 3 nominations.,0,4,3,7
Beautiful Girls,1 win & 3 nominations,0,1,3,4
The Quest,1 nomination.,0,0,1,1
Crash: Extra�os placeres,,0,0,0,0
Eraser,Nominated for 1 Oscar. Another 3 wins & 1 nomination.,1,3,1,5
Race the Sun,,0,0,0,0
Night Falls on Manhattan,1 nomination.,0,0,1,1
Striptease,8 wins & 4 nominations.,0,8,4,12
That Thing You Do!,Nominated for 1 Oscar. Another 3 wins & 7 nominations.,1,3,7,11
Thinner,2 nominations.,0,0,2,2
Garras,,0,0,0,0
Larger Than Life,,0,0,0,0
Mystery Science Theater 3000: The Movie,1 nomination.,0,0,1,1
The Fan,1 win & 3 nominations.,0,1,3,4
Emma,Won 1 Oscar. Another 2 wins & 7 nominations.,1,2,7,10
The Nutty Professor,Won 1 Oscar. Another 9 wins & 12 nominations.,1,9,12,22
From Dusk Till Dawn,7 wins & 13 nominations.,0,7,13,20
Sgt. Bilko,1 win.,0,1,0,1
The Crow: City of Angels,2 wins & 3 nominations.,0,2,3,5
The Crucible,Nominated for 2 Oscars. 4 wins & 29 nominations total,2,4,29,35
Ransom,3 wins & 5 nominations.,0,3,5,8
In Love and War,1 nomination.,0,0,1,1
The Pallbearer,1 nomination.,0,0,1,1
SubUrbia,1 nomination.,0,0,1,1
D3: The Mighty Ducks,2 nominations.,0,0,2,2
Everyone Says I Love You,11 wins & 12 nominations.,0,11,12,23
Kissed,7 wins & 10 nominations.,0,7,10,17
The Craft,1 win & 7 nominations,0,1,7,8
Primal Fear,Nominated for 1 Oscar. Another 10 wins & 11 nominations.,1,10,11,22
Fargo,Won 2 Oscars. Another 81 wins & 58 nominations.,2,81,58,141
House Arrest,1 nomination.,0,0,1,1
Surviving Picasso,,0,0,0,0
Phenomenon,7 wins & 8 nominations,0,7,8,15
Phat Beach,,0,0,0,0
The Spitfire Grill,3 wins.,0,3,0,3
Jack,6 nominations.,0,0,6,6
Fled,,0,0,0,0
Barb Wire,1 win & 7 nominations.,0,1,7,8
It's My Party,1 nomination.,0,0,1,1
Fear,1 win & 2 nominations.,0,1,2,3
The Secret Agent,1 nomination.,0,0,1,1
First Kid,1 nomination.,0,0,1,1
First Contact,,0,0,0,0
Feeling Minnesota,,0,0,0,0
Female Perversions,2 nominations.,0,0,2,2
Carpool,2 wins.,0,2,0,2
Carried Away,,0,0,0,0
Flipper,5 nominations.,0,0,5,5
The Stupids,3 wins & 5 nominations.,0,3,5,8
The Substitute,,0,0,0,0
The Evening Star,Nominated for 1 Golden Globe. Another 6 wins & 2 nominations.,0,6,3,9
Curdled,2 nominations.,0,0,2,2
Evita,Won 1 Oscar. Another 18 wins & 43 nominations.,1,18,43,62
Executive Decision,2 wins & 2 nominations.,0,2,2,4
Extreme Measures,,0,0,0,0
White Squall,1 nomination.,0,0,1,1
Homeward Bound II: Lost in San Francisco,3 nominations.,0,0,3,3
Eye for an Eye,,0,0,0,0
Celtic Pride,,0,0,0,0
The English Patient,Won 9 Oscars. Another 53 wins & 77 nominations.,9,53,77,139
Basquiat,2 wins & 3 nominations.,0,2,3,5
The Rich Man's Wife,,0,0,0,0
Police Story 4: First Strike,,0,0,0,0
One Fine Day,Nominated for 1 Oscar. 4 wins & 6 nominations total,1,4,6,11
Fly Away Home,Nominated for 1 Oscar. Another 5 wins & 6 nominations.,1,5,6,12
The Rock,Nominated for 1 Oscar. Another 9 wins & 8 nominations.,1,9,8,18
The Sunchaser,1 nomination.,0,0,1,1
Flirting with Disaster,1 win & 10 nominations.,0,1,10,11
Caught,,0,0,0,0
My Fellow Americans,,0,0,0,0
Romeo + Juliet,Nominated for 1 Oscar. Another 15 wins & 28 nominations.,1,15,28,44
Last Dance,1 nomination,0,0,1,1
If Lucy Fell,,0,0,0,0
101 Dalmatians,Nominated for 1 BAFTA Film Award. Another 3 wins & 9 nominations.,0,3,10,13
2 Days in the Valley,1 nomination.,0,0,1,1
To Gillian on Her 37th Birthday,1 win.,0,1,0,1
Kama Sutra: A Tale of Love,1 win & 1 nomination.,0,1,1,2
Scream,11 wins & 11 nominations.,0,11,11,22
Tin Cup,Nominated for 1 Golden Globe. Another 3 nominations.,0,0,4,4
Big Night,9 wins & 17 nominations.,0,9,17,26
Down Periscope,,0,0,0,0
Daylight,Nominated for 1 Oscar. 1 win & 4 nominations total,1,1,4,6
Lawnmower Man 2: Beyond Cyberspace,1 nomination.,0,0,1,1
Mother Night,,0,0,0,0
Michael,1 nomination,0,0,1,1
Girl 6,1 nomination.,0,0,1,1
Trees Lounge,4 nominations.,0,0,4,4
Kids in the Hall: Brain Candy,5 nominations.,0,0,5,5
Bad Moon,,0,0,0,0
Santa with Muscles,,0,0,0,0
Trainspotting,Nominated for 1 Oscar. Another 23 wins & 34 nominations.,1,23,34,58
Independence Day,Won 1 Oscar. 35 wins & 35 nominations total,1,35,35,71
DragonHeart,Nominated for 1 Oscar. Another 3 wins & 9 nominations.,1,3,9,13
Stealing Beauty,3 wins & 11 nominations.,0,3,11,14
Black Mask,4 nominations.,0,0,4,4
The Associate,,0,0,0,0
High School High,,0,0,0,0
The Arrival,1 win & 1 nomination.,0,1,1,2
Mission: Impossible,5 wins & 30 nominations.,0,5,30,35
The Funeral,2 wins & 7 nominations.,0,2,7,9
The Long Kiss Goodnight,3 nominations.,0,0,3,3
Bio-Dome,3 wins & 1 nomination.,0,3,1,4
Moll Flanders,4 nominations.,0,0,4,4
Ghosts of Mississippi,Nominated for 2 Oscars. Another 2 wins & 7 nominations.,2,2,7,11
Secrets & Lies,,0,0,0,0
Michael Collins,Nominated for 2 Oscars. Another 4 wins & 15 nominations.,2,4,15,21
The Glimmer Man,,0,0,0,0
The Mirror Has Two Faces,Nominated for 2 Oscars. Another 4 wins & 9 nominations.,2,4,9,15
Ridicule,Nominated for 1 Oscar. Another 20 wins & 16 nominations.,1,20,16,37
The First Wives Club,Nominated for 1 Oscar. Another 3 wins & 7 nominations.,1,3,7,11
Matilda,3 wins & 7 nominations,0,3,7,10
Muppet Treasure Island,5 nominations,0,0,5,5
Multiplicity,,0,0,0,0
Mulholland Falls,1 win & 1 nomination.,0,1,1,2
Muertos de miedo,,0,0,0,0
Dunston Checks In,4 nominations.,0,0,4,4
The Chamber,2 nominations.,0,0,2,2
Don't Be a Menace to South Central While Drinking Your Juice in the Hood,1 nomination.,0,0,1,1
Mrs. Winterbourne,1 nomination.,0,0,1,1
Last Man Standing,,0,0,0,0
Maximum Risk,,0,0,0,0
Twelfth Night or What You Will,,0,0,0,0
Mr. Wrong,1 win & 2 nominations.,0,1,2,3
Eddie,1 win & 2 nominations.,0,1,2,3
Mr. Toad's Wild Ride,2 wins.,0,2,0,2
Blood and Wine,1 win & 1 nomination.,0,1,1,2
Ed,4 nominations.,0,0,4,4
Kazaam,2 nominations.,0,0,2,2
James and the Giant Peach,Nominated for 1 Oscar. Another 4 wins & 12 nominations.,1,4,12,17
The Adventures of Pinocchio,1 win & 2 nominations.,0,1,2,3
Kansas City,3 wins & 1 nomination.,0,3,1,4
Set It Off,5 wins & 6 nominations.,0,5,6,11
Bushwhacked,,0,0,0,0
Carrington,7 wins & 9 nominations total,0,7,9,16
Clueless,6 wins & 11 nominations.,0,6,11,17
The Basketball Diaries,,0,0,0,0
Dead Man,5 wins & 14 nominations.,0,5,14,19
The Doom Generation,1 nomination.,0,0,1,1
Casino,Nominated for 1 Oscar. Another 4 wins & 10 nominations.,1,4,10,15
Casper,4 wins & 5 nominations.,0,4,5,9
Species,3 wins & 6 nominations.,0,3,6,9
The Brady Bunch Movie,3 nominations.,0,0,3,3
The Baby-Sitters Club,2 wins & 1 nomination.,0,2,1,3
Jack & Sarah,6 nominations.,0,0,6,6
Crimson Tide,Nominated for 3 Oscars. Another 5 wins & 6 nominations.,3,5,6,14
The American President,Nominated for 1 Oscar. Another 1 win & 9 nominations.,1,1,9,11
Dead Man Walking,Won 1 Oscar. Another 22 wins & 23 nominations.,1,22,23,46
Sudden Death,,0,0,0,0
Clockers,6 nominations,0,0,6,6
Jeffrey,1 win & 4 nominations.,0,1,4,5
Copycat,2 wins & 1 nomination.,0,2,1,3
Stuart Saves His Family,2 nominations.,0,0,2,2
The Grass Harp,3 wins.,0,3,0,3
The Big Green,,0,0,0,0
The Fantasticks,,0,0,0,0
Jefferson in Paris,2 nominations.,0,0,2,2
Strange Days,2 wins & 4 nominations.,0,2,4,6
Jade,2 nominations,0,0,2,2
Congo,2 wins & 11 nominations,0,2,11,13
3 Ninjas Knuckle Up,2 nominations.,0,0,2,2
The Flower of My Secret,5 wins & 13 nominations.,0,5,13,18
C�rculo de amigos,,0,0,0,0
The Englishman Who Went Up a Hill But Came Down a Mountain,1 win & 1 nomination.,0,1,1,2
Dangerous Minds,6 wins & 8 nominations.,0,6,8,14
Tales from the Crypt: Demon Knight,2 wins & 1 nomination.,0,2,1,3
Tales from the Hood,,0,0,0,0
The Bridges of Madison County,Nominated for 1 Oscar. Another 7 wins & 17 nominations.,1,7,17,25
The City of Lost Children,5 wins & 14 nominations.,0,5,14,19
Tall Tale,,0,0,0,0
Bye Bye Love,1 nomination.,0,0,1,1
The Brothers McMullen,4 wins & 1 nomination.,0,4,1,5
Candyman: Farewell to the Flesh,,0,0,0,0
The Amazing Panda Adventure,3 nominations.,0,0,3,3
Cutthroat Island,1 nomination.,0,0,1,1
Tank Girl,,0,0,0,0
Canadian Bacon,,0,0,0,0
The Day of the Beast,16 wins & 14 nominations.,0,16,14,30
Dead Presidents,2 nominations.,0,0,2,2
The Crossing Guard,Nominated for 1 Golden Globe. Another 3 nominations.,0,0,4,4
The Perez Family,,0,0,0,0
When Night Is Falling,5 nominations.,0,0,5,5
Hideaway,1 nomination.,0,0,1,1
Higher Learning,1 win & 1 nomination.,0,1,1,2
Wild Bill,Nominated for 1 BAFTA Film Award. Another 3 wins & 7 nominations.,0,3,8,11
"To Wong Foo Thanks for Everything, Julie Newmar",Nominated for 2 Golden Globes. Another 1 nomination.,0,0,3,3
An Awfully Big Adventure,2 nominations.,0,0,2,2
Killer: A Journal of Murder,2 wins & 2 nominations.,0,2,2,4
Moonlight and Valentino,,0,0,0,0
To Die For,Won 1 Golden Globe. Another 6 wins & 13 nominations.,0,7,13,20
Mortal Kombat,1 win & 3 nominations,0,1,3,4
Last of the Dogmen,,0,0,0,0
Mr. Holland's Opus,Nominated for 1 Oscar. Another 5 wins & 4 nominations.,1,5,4,10
Houseguest,,0,0,0,0
Before Sunrise,1 win & 7 nominations.,0,1,7,8
Three Wishes,1 nomination.,0,0,1,1
Get Shorty,Won 1 Golden Globe. Another 5 wins & 16 nominations.,0,6,16,22
The Prophecy,2 wins & 2 nominations.,0,2,2,4
Kiss of Death,1 nomination.,0,0,1,1
Welcome to the Dollhouse,4 wins & 17 nominations.,0,4,17,21
Murder in the First,2 wins & 2 nominations.,0,2,2,4
Mute Witness,3 wins & 3 nominations.,0,3,3,6
Georgia,Nominated for 1 Oscar. Another 4 wins & 6 nominations.,1,4,6,11
Powder,1 win & 1 nomination.,0,1,1,2
Angels and Insects,Nominated for 1 Oscar. Another 2 wins & 2 nominations.,1,2,2,5
Tom and Huck,1 win & 5 nominations.,0,1,5,6
Empire Records,1 win.,0,1,0,1
Money Train,1 nomination,0,0,1,1
Richard III,Nominated for 2 Oscars. 7 wins & 12 nominations total,2,7,12,21
Roommates,Nominated for 1 Oscar. Another 1 nomination.,1,0,1,2
Waterworld,Nominated for 1 Oscar. Another 6 wins & 8 nominations.,1,6,8,15
Miami Rhapsody,1 nomination,0,0,1,1
Mighty Aphrodite,Won 1 Oscar. Another 11 wins & 13 nominations.,1,11,13,25
Beyond Rangoon,2 wins & 3 nominations.,0,2,3,5
Rob Roy,Nominated for 1 Oscar. Another 2 wins & 4 nominations.,1,2,4,7
Mighty Morphin Power Rangers: The Movie,1 nomination.,0,0,1,1
Kicking and Screaming,2 nominations.,0,0,2,2
Gordy,1 win.,0,1,0,1
Toy Story,Nominated for 3 Oscars. Another 27 wins & 20 nominations.,3,27,20,50
Tommy Boy,1 win & 2 nominations.,0,1,2,3
Restoration,Won 2 Oscars. Another 2 nominations.,2,0,2,4
A Month by the Lake,,0,0,0,0
The Net,2 wins.,0,2,0,2
GoldenEye,2 wins & 8 nominations total,0,2,8,10
El triturador,,0,0,0,0
Total Eclipse,1 nomination.,0,0,1,1
A Midwinter's Tale,1 win & 1 nomination.,0,1,1,2
Top Dog,,0,0,0,0
How to Make an American Quilt,4 nominations.,0,0,4,4
Batman Forever,Nominated for 3 Oscars. Another 10 wins & 23 nominations.,3,10,23,36
Operation Dumbo Drop,,0,0,0,0
Nick of Time,,0,0,0,0
Outbreak,5 wins & 5 nominations,0,5,5,10
Friday,1 win & 5 nominations.,0,1,5,6
The Star Maker,Nominated for 1 Oscar. Another 13 wins & 15 nominations.,1,13,15,29
A Kid in King Arthur's Court,1 nomination.,0,0,1,1
Nine Months,1 win & 2 nominations,0,1,2,3
Flirt,,0,0,0,0
Othello,3 nominations.,0,0,3,3
"Babe, el puerquito valiente",,0,0,0,0
French Kiss,2 nominations.,0,0,2,2
Nixon,Nominated for 4 Oscars. Another 11 wins & 14 nominations.,4,11,14,29
Apollo 13,Won 2 Oscars. 28 wins & 59 nominations total,2,28,59,89
Free Willy 2: The Adventure Home,2 wins & 2 nominations.,0,2,2,4
Fluke,2 nominations,0,0,2,2
The Usual Suspects,Won 2 Oscars. Another 35 wins & 17 nominations.,2,35,17,54
Asesinos cibern�ticos,,0,0,0,0
The Underneath,1 nomination.,0,0,1,1
La piedra y el ping�ino,,0,0,0,0
Forget Paris,1 win.,0,1,0,1
Now and Then,1 nomination.,0,0,1,1
Home for the Holidays,2 nominations.,0,0,2,2
Four Rooms,1 win & 1 nomination.,0,1,1,2
A Little Princess,Nominated for 2 Oscars. Another 3 wins & 7 nominations.,2,3,7,12
Things to Do in Denver When You're Dead,2 wins,0,2,0,2
A Goofy Movie,5 nominations.,0,0,5,5
Pocahontas,Won 2 Oscars. Another 13 wins & 7 nominations.,2,13,7,22
White Man's Burden,,0,0,0,0
Far from Home: The Adventures of Yellow Dog,3 nominations.,0,0,3,3
Angus,1 nomination.,0,0,1,1
The Scarlet Letter,1 win & 10 nominations.,0,1,10,11
Napoleon,4 wins.,0,4,0,4
Father of the Bride Part II,1 win & 2 nominations.,0,1,2,3
Antonia's Line,Won 1 Oscar. Another 7 wins & 10 nominations.,1,7,10,18
Balto,5 nominations.,0,0,5,5
Funny Bones,8 wins.,0,8,0,8
Bad Boys,4 nominations,0,0,4,4
While You Were Sleeping,4 wins & 5 nominations.,0,4,5,9
Party Girl,1 nomination,0,0,1,1
Never Talk to Strangers,,0,0,0,0
Panther,2 wins & 2 nominations.,0,2,2,4
New Jersey Drive,3 nominations.,0,0,3,3
First Knight,,0,0,0,0
Rumble in the Bronx,2 wins & 11 nominations.,0,2,11,13
Gold Diggers: The Secret of Bear Mountain,1 win & 1 nomination.,0,1,1,2
Vampire in Brooklyn,,0,0,0,0
Showgirls,10 wins & 10 nominations,0,10,10,20
The Incredibly True Adventure of Two Girls in Love,1 win.,0,1,0,1
The Indian in the Cupboard,1 win & 6 nominations,0,1,6,7
Blue in the Face,2 nominations.,0,0,2,2
Ace Ventura: When Nature Calls,7 wins & 6 nominations,0,7,6,13
Waiting to Exhale,9 wins & 10 nominations.,0,9,10,19
Judge Dredd,2 wins & 5 nominations.,0,2,5,7
The Jerky Boys,,0,0,0,0
Unstrung Heroes,Nominated for 1 Oscar. Another 2 nominations.,1,0,2,3
Dolores Claiborne,1 win & 8 nominations.,0,1,8,9
Adi�s a Las Vegas,,0,0,0,0
Mad Love,,0,0,0,0
Magic in the Water,2 wins & 5 nominations.,0,2,5,7
Separate Lives,,0,0,0,0
Sense and Sensibility,Won 1 Oscar. Another 32 wins & 49 nominations.,1,32,49,82
Senior Trip,,0,0,0,0
Major Payne,,0,0,0,0
Jumanji,4 wins & 11 nominations.,0,4,11,15
Under Siege 2: Dark Territory,,0,0,0,0
Mallrats,,0,0,0,0
Die Hard with a Vengeance,2 wins & 3 nominations.,0,2,3,5
Johnny Mnemonic,2 wins & 3 nominations.,0,2,3,5
Losing Isaiah,1 nomination.,0,0,1,1
Virtuosity,1 nomination.,0,0,1,1
Village of the Damned,2 nominations.,0,0,2,2
Something to Talk About,Nominated for 1 Golden Globe. Another 1 win & 2 nominations.,0,1,3,4
Heavy Weights,,0,0,0,0
Braveheart,Won 5 Oscars. Another 28 wins & 34 nominations.,5,28,34,67
Boys on the Side,1 win & 2 nominations.,0,1,2,3
The Horseman on the Roof,4 wins & 8 nominations.,0,4,8,12
Smoke,11 wins & 9 nominations.,0,11,9,20
Living in Oblivion,7 wins & 8 nominations,0,7,8,15
Delta of Venus,,0,0,0,0
Desperado,1 win & 5 nominations.,0,1,5,6
A Walk in the Clouds,1 win & 6 nominations.,0,1,6,7
Born to Be Wild,2 wins.,0,2,0,2
Heavy,3 wins & 3 nominations.,0,3,3,6
Destiny Turns on the Radio,,0,0,0,0
Lord of Illusions,2 wins & 1 nomination.,0,2,1,3
Devil in a Blue Dress,3 wins & 13 nominations.,0,3,13,16
Assassins,1 win & 1 nomination.,0,1,1,2
Grumpier Old Men,2 wins & 2 nominations.,0,2,2,4
Two Bits,2 nominations.,0,0,2,2
Dr. Jekyll and Ms. Hyde,4 nominations.,0,0,4,4
R�pida y mortal,,0,0,0,0
Twelve Monkeys,,0,0,0,0
The Last Supper,1 win & 1 nomination.,0,1,1,2
Sabrina,Won 1 Oscar. Another 6 wins & 8 nominations.,1,6,8,15
Billy Madison,1 nomination.,0,0,1,1
Dr�cula: Muerto pero feliz,,0,0,0,0
Jury Duty,1 win & 1 nomination.,0,1,1,2
Just Cause,1 win.,0,1,0,1
Wings of Courage,,0,0,0,0
Hackers,,0,0,0,0
Halloween: The Curse of Michael Myers,3 wins & 1 nomination,0,3,1,4
Se7en,Nominated for 1 Oscar. 29 wins & 42 nominations total,1,29,42,72
Color of Night,2 wins & 11 nominations.,0,2,11,13
Iron Will,,0,0,0,0
Fresh,4 wins & 4 nominations.,0,4,4,8
Nell,Nominated for 1 Oscar. Another 5 wins & 6 nominations.,1,5,6,12
Cobb,1 nomination.,0,0,1,1
Vanya on 42nd Street,2 wins & 12 nominations.,0,2,12,14
Maverick,Nominated for 1 Oscar. Another 1 win & 1 nomination.,1,1,1,3
True Lies,Nominated for 1 Oscar. Another 8 wins & 22 nominations.,1,8,22,31
Miracle on 34th Street,Won 3 Oscars. Another 5 wins & 1 nomination.,3,5,1,9
In the Mouth of Madness,1 win & 4 nominations.,0,1,4,5
Love Affair,,0,0,0,0
Maybe... Maybe Not,10 wins & 1 nomination.,0,10,1,11
New Nightmare,3 wins & 7 nominations,0,3,7,10
"Corrina, Corrina",3 nominations.,0,0,3,3
Guarding Tess,Nominated for 1 Golden Globe. Another 1 nomination.,0,0,2,2
Wagons East,,0,0,0,0
The Chase,,0,0,0,0
Legends of the Fall,Won 1 Oscar. 3 wins & 12 nominations total,1,3,12,16
City Slickers II: The Legend of Curly's Gold,2 nominations.,0,0,2,2
"Little Indian, Big City",,0,0,0,0
Little Odessa,4 wins & 7 nominations.,0,4,7,11
Trapped in Paradise,,0,0,0,0
Little Women,Won 1 Oscar. Another 75 wins & 216 nominations.,1,75,216,292
Ashes of Time,9 wins & 16 nominations.,0,9,16,25
Mi adorable delincuente,,0,0,0,0
Greedy,,0,0,0,0
Holy Matrimony,,0,0,0,0
Trading Mom,,0,0,0,0
It Could Happen to You,,0,0,0,0
Little Big League,2 nominations.,0,0,2,2
The War,1 win & 3 nominations,0,1,3,4
China Moon,,0,0,0,0
Terminal Velocity,,0,0,0,0
Amateur,1 win & 2 nominations.,0,1,2,3
Milk Money,1 nomination.,0,0,1,1
Above the Rim,1 nomination.,0,0,1,1
Clean Slate,,0,0,0,0
Go Fish,4 wins & 4 nominations.,0,4,4,8
Intersection,2 wins.,0,2,0,2
My Father the Hero,1 nomination,0,0,1,1
L�on: The Professional,,0,0,0,0
A Low Down Dirty Shame,1 nomination.,0,0,1,1
Andre,4 nominations.,0,0,4,4
The Cowboy Way,,0,0,0,0
War of the Buttons,2 nominations.,0,0,2,2
Three Colors: Red,Nominated for 3 Oscars. Another 19 wins & 26 nominations.,3,19,26,48
Three Colors: White,2 wins & 7 nominations.,0,2,7,9
Mary Shelley's Frankenstein,Nominated for 1 Oscar. Another 19 nominations.,1,0,19,20
Major League II,1 win & 1 nomination.,0,1,1,2
Ladybird Ladybird,6 wins & 3 nominations.,0,6,3,9
A Pure Formality,5 wins & 9 nominations.,0,5,9,14
The Air Up There,,0,0,0,0
Getting Even with Dad,2 nominations.,0,0,2,2
Mrs. Parker and the Vicious Circle,Nominated for 1 Golden Globe. Another 2 wins & 7 nominations.,0,2,8,10
Threesome,,0,0,0,0
Through the Olive Trees,5 wins & 7 nominations.,0,5,7,12
Airheads,,0,0,0,0
Highlander: The Final Dimension,1 nomination.,0,0,1,1
A Simple Twist of Fate,2 nominations.,0,0,2,2
Timecop: Polic�a del futuro,,0,0,0,0
Leprechaun 2,1 win.,0,1,0,1
Lassie,1 win & 1 nomination.,0,1,1,2
Angels in the Outfield,1 win & 4 nominations.,0,1,4,5
Angie,1 nomination.,0,0,1,1
In the Army Now,,0,0,0,0
Interview with the Vampire: The Vampire Chronicles,Nominated for 2 Oscars. 24 wins & 36 nominations total,2,24,36,62
Mosquito,1 nomination.,0,0,1,1
The Client,Nominated for 1 Oscar. Another 3 wins & 3 nominations.,1,3,3,7
Cops and Robbersons,,0,0,0,0
Ace Ventura: Pet Detective,5 wins & 5 nominations.,0,5,5,10
Natural Born Killers,Nominated for 1 Golden Globe. Another 5 wins & 10 nominations.,0,5,11,16
Clear and Present Danger,Nominated for 2 Oscars. 3 wins & 11 nominations total,2,3,11,16
Clerks,6 wins & 10 nominations.,0,6,10,16
Mixed Nuts,1 nomination.,0,0,1,1
Naked Gun 33 1/3: The Final Insult,3 wins.,0,3,0,3
The Crow,5 wins & 7 nominations.,0,5,7,12
Nadja,2 wins & 5 nominations.,0,2,5,7
Texas Chainsaw Massacre: The Next Generation,,0,0,0,0
Chasers,,0,0,0,0
There Goes My Baby,1 nomination.,0,0,1,1
The Browning Version,Nominated for 2 BAFTA Film Awards. Another 7 wins & 1 nomination.,0,7,3,10
"Las aventuras de Priscilla, reina del desierto",,0,0,0,0
Clifford,,0,0,0,0
Lightning Jack,,0,0,0,0
Chungking Express,,0,0,0,0
My Girl 2,1 win & 2 nominations.,0,1,2,3
Death Machine,1 win & 2 nominations.,0,1,2,3
North,4 wins & 9 nominations.,0,4,9,13
The Madness of King George,Won 1 Oscar. Another 15 wins & 20 nominations.,1,15,20,36
The Flintstones,6 wins & 10 nominations.,0,6,10,16
Cabin Boy,2 nominations.,0,0,2,2
Ed Wood,Won 2 Oscars. Another 25 wins & 34 nominations.,2,25,34,61
The Mask,Nominated for 1 Oscar. Another 6 wins & 20 nominations.,1,6,20,27
Dumb and Dumber,5 wins & 3 nominations.,0,5,3,8
Drop Zone,,0,0,0,0
El Libro de la Selva,,0,0,0,0
S.F.W.,5 nominations.,0,0,5,5
Il Postino,Won 1 Oscar. Another 31 wins & 20 nominations.,1,31,20,52
The Little Rascals,2 wins.,0,2,0,2
The Lion King,Won 2 Oscars. 39 wins & 35 nominations total,2,39,35,76
Black Beauty,1 win & 1 nomination.,0,1,1,2
The Getaway,1 win & 3 nominations,0,1,3,4
The Legend of Drunken Master,3 wins & 1 nomination.,0,3,1,4
Beverly Hills Cop III,3 nominations,0,0,3,3
The Monster,6 nominations.,0,0,6,6
Burnt by the Sun,Won 1 Oscar. Another 4 wins & 10 nominations.,1,4,10,15
Rapa Nui,1 win & 1 nomination.,0,1,1,2
Quiz Show,Nominated for 4 Oscars. Another 6 wins & 32 nominations.,4,6,32,42
Little Giants,,0,0,0,0
D2: The Mighty Ducks,,0,0,0,0
Radioland Murders,,0,0,0,0
The Paper,,0,0,0,0
The Pagemaster,5 nominations.,0,0,5,5
Ready to Wear,3 wins & 3 nominations.,0,3,3,6
Dance Me Outside,4 wins & 2 nominations.,0,4,2,6
Reality Bites,2 nominations,0,0,2,2
Renaissance Man,,0,0,0,0
Four Weddings and a Funeral,Nominated for 2 Oscars. Another 24 wins & 26 nominations.,2,24,26,52
The Favor,,0,0,0,0
Street Fighter,2 nominations.,0,0,2,2
The Next Karate Kid,1 win.,0,1,0,1
With Honors,Nominated for 1 Golden Globe. Another 3 nominations.,0,0,4,4
The Last Seduction,Nominated for 1 BAFTA Film Award. Another 9 wins & 9 nominations.,0,9,10,19
Camp Nowhere,,0,0,0,0
The Hudsucker Proxy,3 wins & 4 nominations.,0,3,4,7
Blue Sky,Won 1 Oscar. Another 3 wins & 5 nominations.,1,3,5,9
Squanto: A Warrior's Tale,,0,0,0,0
8 Seconds,,0,0,0,0
Silent Fall,1 nomination.,0,0,1,1
Wyatt Earp,Nominated for 1 Oscar. 3 wins & 7 nominations total,1,3,7,11
I'll Do Anything,1 win & 2 nominations.,0,1,2,3
Sister My Sister,4 wins & 1 nomination.,0,4,1,5
Sleep with Me,1 nomination.,0,0,1,1
Disclosure,2 wins & 2 nominations,0,2,2,4
Brainscan,1 nomination.,0,0,1,1
Speed,Won 2 Oscars. Another 18 wins & 20 nominations.,2,18,20,40
Somos guerreros,,0,0,0,0
Death and the Maiden,5 nominations.,0,0,5,5
Death Wish V: The Face of Death,,0,0,0,0
Jimmy Hollywood,,0,0,0,0
Blue Chips,1 nomination.,0,0,1,1
Blown Away,2 nominations.,0,0,2,2
De amor y de sombras,,0,0,0,0
Blank Check,,0,0,0,0
Blankman,,0,0,0,0
Junior,Nominated for 1 Oscar. Another 4 nominations.,1,0,4,5
Wolf,2 wins & 10 nominations.,0,2,10,12
Double Happiness,6 wins & 6 nominations.,0,6,6,12
Double Dragon,,0,0,0,0
Stargate: la puerta del tiempo,,0,0,0,0
I Like It Like That,1 win & 5 nominations.,0,1,5,6
Shallow Grave,14 wins & 1 nomination.,0,14,1,15
Bullets Over Broadway,Won 1 Oscar. Another 21 wins & 30 nominations.,1,21,30,52
Star Trek: Generations,2 wins & 4 nominations.,0,2,4,6
Don Juan DeMarco,Nominated for 1 Oscar. Another 4 wins & 4 nominations.,1,4,4,9
I Love Trouble,,0,0,0,0
Serial Mom,1 nomination.,0,0,1,1
The Glass Shield,1 nomination.,0,0,1,1
Jason's Lyric,1 nomination.,0,0,1,1
Queen Margot,Nominated for 1 Oscar. Another 10 wins & 16 nominations.,1,10,16,27
3 Ninjas Kick Back,3 nominations.,0,0,3,3
A Troll in Central Park,,0,0,0,0
Baby's Day Out,,0,0,0,0
The Swan Princess,1 win & 8 nominations.,0,1,8,9
The Sum of Us,6 wins & 5 nominations.,0,6,5,11
Police Academy: Mission to Moscow,,0,0,0,0
It's Pat: The Movie,1 win & 7 nominations.,0,1,7,8
The River Wild,Nominated for 2 Golden Globes. Another 2 nominations.,0,0,4,4
House Party 3,,0,0,0,0
The Road to Wellville,3 nominations.,0,0,3,3
White Fang 2: Myth of the White Wolf,,0,0,0,0
Farinelli,Nominated for 1 Oscar. Another 6 wins & 3 nominations.,1,6,3,10
La boda de Muriel,,0,0,0,0
Surviving the Game,1 nomination.,0,0,1,1
Barcelona,1 win & 1 nomination.,0,1,1,2
The Santa Clause,2 wins & 8 nominations.,0,2,8,10
Criaturas celestiales,,0,0,0,0
A Good Man in Africa,,0,0,0,0
I.Q.,,0,0,0,0
Backbeat,5 wins & 4 nominations total,0,5,4,9
The Scout,,0,0,0,0
The Specialist,4 wins & 7 nominations,0,4,7,11
When a Man Loves a Woman,4 nominations.,0,0,4,4
The Secret of Roan Inish,1 win & 9 nominations.,0,1,9,10
The Shadow,4 nominations.,0,0,4,4
Swimming with Sharks,4 wins & 4 nominations.,0,4,4,8
The Shawshank Redemption,Nominated for 7 Oscars. 21 wins & 43 nominations total,7,21,43,71
Bad Girls,,0,0,0,0
PCU,,0,0,0,0
"Car 54, Where Are You?",2 wins & 2 nominations.,0,2,2,4
La fille de d'Artagnan,,0,0,0,0
Crooklyn,3 nominations.,0,0,3,3
Pulgarcita,,0,0,0,0
The Puppet Masters,2 nominations.,0,0,2,2
On Deadly Ground,1 win & 6 nominations.,0,1,6,7
Princess Caraboo,,0,0,0,0
Cemetery Man,9 wins & 11 nominations.,0,9,11,20
Exit to Eden,1 win & 4 nominations.,0,1,4,5
Immortal Beloved,1 nomination,0,0,1,1
Pulp Fiction,Won 1 Oscar. Another 69 wins & 75 nominations.,1,69,75,145
Only You,,0,0,0,0
Ex�tica,,0,0,0,0
Forrest Gump,Won 6 Oscars. Another 44 wins & 75 nominations.,6,44,75,125
The Ref,1 win & 1 nomination.,0,1,1,2
A Home of Our Own,1 win & 3 nominations.,0,1,3,4
Blink,2 nominations.,0,0,2,2
The Thing Called Love,,0,0,0,0
Airborne,,0,0,0,0
Aspen Extreme,,0,0,0,0
Undercover Blues,,0,0,0,0
The Wedding Banquet,,0,0,0,0
Arizona Dream,4 wins & 2 nominations.,0,4,2,6
Body Snatchers,6 nominations.,0,0,6,6
"Blood In, Blood Out",1 win & 1 nomination.,0,1,1,2
The Joy Luck Club,Nominated for 1 BAFTA Film Award. Another 4 wins & 4 nominations.,0,4,5,9
"Bodies, Rest & Motion",1 win & 1 nomination.,0,1,1,2
What's Love Got to Do with It,Nominated for 2 Oscars. Another 3 wins & 13 nominations.,2,3,13,18
What's Eating Gilbert Grape,Nominated for 1 Oscar. Another 8 wins & 6 nominations.,1,8,6,15
The Temp,1 win & 1 nomination.,0,1,1,2
The Good Son,1 win & 2 nominations.,0,1,2,3
The Vanishing,7 wins & 6 nominations.,0,7,6,13
Born Yesterday,Won 1 Oscar. 5 wins & 10 nominations total,1,5,10,16
Wrestling Ernest Hemingway,,0,0,0,0
The Thief and the Cobbler,,0,0,0,0
The Dark Half,4 wins & 11 nominations.,0,4,11,15
Addams Family Values,Nominated for 1 Oscar. Another 3 wins & 15 nominations.,1,3,15,19
Boxing Helena,1 win & 2 nominations.,0,1,2,3
Untamed Heart,2 wins & 1 nomination.,0,2,1,3
Beethoven's 2nd,Nominated for 1 Oscar. Another 4 nominations.,1,0,4,5
The Slingshot,1 win & 4 nominations.,0,1,4,5
The Nutcracker,,0,0,0,0
The Remains of the Day,Nominated for 8 Oscars. Another 17 wins & 33 nominations.,8,17,33,58
The Firm,Nominated for 2 Oscars. Another 3 wins & 5 nominations.,2,3,5,10
Amos & Andrew,Nominated for 3 Golden Globes. Another 4 nominations.,0,0,7,7
Best of the Best II,,0,0,0,0
The Nightmare Before Christmas,Nominated for 1 Oscar. Another 7 wins & 16 nominations.,1,7,16,24
The Real McCoy,,0,0,0,0
Calendar Girl,,0,0,0,0
Three Colors: Blue,Nominated for 3 Golden Globes. Another 21 wins & 15 nominations.,0,21,18,39
We're Back! A Dinosaur's Story,,0,0,0,0
Wilder Napalm,,0,0,0,0
Tombstone,2 nominations.,0,0,2,2
Benny & Joon,,0,0,0,0
The Program,,0,0,0,0
A Far Off Place,,0,0,0,0
Three of Hearts,,0,0,0,0
A Dangerous Woman,1 win & 4 nominations.,0,1,4,5
The Pelican Brief,1 win & 2 nominations.,0,1,2,3
Weekend at Bernie's II,1 win & 1 nomination.,0,1,1,2
Who's the Man?,,0,0,0,0
This Boy's Life,2 wins & 2 nominations.,0,2,2,4
The Meteor Man,1 nomination.,0,0,1,1
Un d�a de furia,,0,0,0,0
The Crush,2 wins & 3 nominations.,0,2,3,5
Alive,Nominated for 1 Primetime Emmy. Another 1 win & 1 nomination.,0,1,2,3
Carnosaur,,0,0,0,0
The Secret Garden,Nominated for 1 BAFTA Film Award. Another 3 wins & 5 nominations.,0,3,6,9
A Perfect World,1 win & 1 nomination.,0,1,1,2
Wide Sargasso Sea,,0,0,0,0
Warlock: The Armageddon,2 nominations.,0,0,2,2
Witchboard 2,,0,0,0,0
Another Stakeout,1 nomination.,0,0,1,1
Batman: Mask of the Phantasm,1 nomination.,0,0,1,1
True Romance,1 win & 10 nominations.,0,1,10,11
A Bronx Tale,1 win & 3 nominations,0,1,3,4
The Sandlot,1 nomination,0,0,1,1
The Fugitive,Won 1 Oscar. Another 12 wins & 37 nominations.,1,12,37,50
Watch It,,0,0,0,0
The Saint of Fort Washington,1 win & 2 nominations.,0,1,2,3
The Man Without a Face,3 nominations.,0,0,3,3
CB4,,0,0,0,0
Wayne's World 2,3 nominations.,0,0,3,3
Carlito's Way,2 wins & 9 nominations.,0,2,9,11
Splitting Heirs,1 nomination.,0,0,1,1
Naked in New York,1 win & 1 nomination.,0,1,1,2
Once Upon a Forest,1 win & 1 nomination.,0,1,1,2
Needful Things,1 win & 6 nominations.,0,1,6,7
Swing Kids,1 win & 1 nomination.,0,1,1,2
Free Willy,7 wins & 2 nominations.,0,7,2,9
Freaked,2 wins & 9 nominations.,0,2,9,11
Nowhere to Run,1 nomination.,0,0,1,1
Surf Ninjas,1 nomination.,0,0,1,1
For the Moment,2 wins & 2 nominations.,0,2,2,4
For Love or Money,,0,0,0,0
Super Mario Bros.,2 nominations,0,0,2,2
Once Upon a Time in China III,1 win & 1 nomination.,0,1,1,2
My Boyfriend's Back,,0,0,0,0
Only the Strong,,0,0,0,0
Fire in the Sky,4 nominations.,0,0,4,4
Sugar Hill,,0,0,0,0
Striking Distance,,0,0,0,0
Fear of a Black Hat,1 nomination,0,0,1,1
Father Hood,,0,0,0,0
Fatal Instinct,,0,0,0,0
Philadelphia,Won 2 Oscars. 20 wins & 23 nominations total,2,20,23,45
My Life,,0,0,0,0
Cronos,23 wins & 13 nominations,0,23,13,36
Teenage Mutant Ninja Turtles III,1 win.,0,1,0,1
Manhattan Murder Mystery,Nominated for 1 Golden Globe. Another 3 nominations.,0,0,4,4
Matinee,1 win.,0,1,0,1
Gunmen,,0,0,0,0
Guilty as Sin,1 win.,0,1,0,1
Grumpy Old Men,1 win & 1 nomination,0,1,1,2
Groundhog Day,Won 1 BAFTA Film Award. Another 6 wins & 17 nominations.,0,7,17,24
Menace II Society,2 wins & 4 nominations.,0,2,4,6
Mi vida loca,,0,0,0,0
Money for Nothing,,0,0,0,0
Crime Story,2 wins & 8 nominations.,0,2,8,10
Germinal,2 wins & 11 nominations.,0,2,11,13
Mother's Boys,1 nomination.,0,0,1,1
Ghost in the Machine,,0,0,0,0
Mr. Jones,4 wins & 12 nominations.,0,4,12,16
Mr. Nanny,2 nominations.,0,0,2,2
Mr. Wonderful,,0,0,0,0
Gettysburg,1 win & 1 nomination.,0,1,1,2
Mrs. Doubtfire,Won 1 Oscar. Another 10 wins & 10 nominations.,1,10,10,21
Geronimo: An American Legend,Nominated for 1 Oscar. Another 1 win & 1 nomination.,1,1,1,3
Philadelphia Experiment II,,0,0,0,0
Strawberry and Chocolate,Nominated for 1 Oscar. Another 25 wins & 1 nomination.,1,25,1,27
Farewell My Concubine,Nominated for 2 Oscars. Another 25 wins & 10 nominations.,2,25,10,37
Dragon: The Bruce Lee Story,1 win & 3 nominations.,0,1,3,4
Schindler's List,Won 7 Oscars. Another 85 wins & 49 nominations.,7,85,49,141
Searching for Bobby Fischer,Nominated for 1 Oscar. 5 wins & 10 nominations total,1,5,10,16
Shadowlands,Nominated for 2 Oscars. Another 7 wins & 12 nominations.,2,7,12,21
Short Cuts,Nominated for 1 Oscar. Another 17 wins & 18 nominations.,1,17,18,36
Silent Tongue,1 nomination.,0,0,1,1
Sirenas,,0,0,0,0
"Faraway, So Close!",1 nomination.,0,0,1,1
Sister Act 2: Back in the Habit,1 win & 3 nominations.,0,1,3,4
Six Degrees of Separation,Nominated for 1 Oscar. Another 5 nominations.,1,0,5,6
Sleepless in Seattle,Nominated for 2 Oscars. 4 wins & 19 nominations total,2,4,19,25
Dennis the Menace,3 wins & 3 nominations.,0,3,3,6
Sliver,4 wins & 9 nominations.,0,4,9,13
Demolition Man,1 win & 7 nominations.,0,1,7,8
Sniper,,0,0,0,0
So I Married an Axe Murderer,,0,0,0,0
Sommersby,2 wins.,0,2,0,2
Son in Law,1 nomination.,0,0,1,1
Rudy,2 wins & 1 nomination.,0,2,1,3
Ruby in Paradise,3 wins & 7 nominations.,0,3,7,10
Poetic Justice,Nominated for 1 Oscar. Another 4 wins & 4 nominations.,1,4,4,9
Point of No Return,,0,0,0,0
Posse,1 nomination.,0,0,1,1
Even Cowgirls Get the Blues,4 nominations.,0,0,4,4
Ethan Frome,,0,0,0,0
Dangerous Game,1 win & 1 nomination.,0,1,1,2
En el nombre del padre,,0,0,0,0
Red Rock West,3 nominations.,0,0,3,3
El piano,,0,0,0,0
El cuerpo del delito,,0,0,0,0
Return of the Living Dead III,3 wins & 1 nomination,0,3,1,4
El cielo y la tierra,,0,0,0,0
Rising Sun,1 win & 1 nomination.,0,1,1,2
Robin Hood: Men in Tights,1 nomination.,0,0,1,1
RoboCop 3,3 nominations.,0,0,3,3
Romeo Is Bleeding,2 nominations.,0,0,2,2
Dave,Nominated for 1 Oscar. Another 2 wins & 5 nominations.,1,2,5,8
Rookie of the Year,1 win & 1 nomination.,0,1,1,2
Dazed and Confused,1 win & 4 nominations.,0,1,4,5
Man's Best Friend,1 win & 5 nominations.,0,1,5,6
Son of the Pink Panther,3 nominations.,0,0,3,3
The Advocate,,0,0,0,0
The Adventures of Huck Finn,,0,0,0,0
Cool Runnings,2 wins & 2 nominations,0,2,2,4
M. Butterfly,1 win & 1 nomination.,0,1,1,2
Hexed,,0,0,0,0
Cliffhanger,Nominated for 3 Oscars. Another 1 win & 9 nominations.,3,1,9,13
Judgment Night,,0,0,0,0
The Ballad of Little Jo,2 nominations.,0,0,2,2
Heart and Souls,1 win & 10 nominations.,0,1,10,11
Hot Shots! Part Deux,1 win.,0,1,0,1
Love & Human Remains,2 wins & 1 nomination.,0,2,1,3
Lost in Yonkers,1 nomination.,0,0,1,1
Los visitantes,1 nomination.,0,0,1,1
La casa de los esp�ritus,,0,0,0,0
Look Who's Talking Now,1 win & 4 nominations.,0,1,4,5
Jurassic Park,Won 3 Oscars. Another 42 wins & 27 nominations.,3,42,27,72
Coneheads,2 nominations.,0,0,2,2
The Beverly Hillbillies,1 win & 1 nomination.,0,1,1,2
Loaded Weapon 1,,0,0,0,0
Life with Mikey,2 wins & 2 nominations.,0,2,2,4
The Age of Innocence,Won 1 Oscar. Another 14 wins & 33 nominations.,1,14,33,48
Kalifornia,4 wins & 4 nominations.,0,4,4,8
Killing Zoe,2 wins & 1 nomination.,0,2,1,3
Little Buddha,2 wins & 3 nominations,0,2,3,5
Jason Goes to Hell: The Final Friday,5 nominations.,0,0,5,5
Josh and S.A.M.,,0,0,0,0
Hocus Pocus,2 wins & 11 nominations.,0,2,11,13
Iron Monkey,2 nominations.,0,0,2,2
Cop & �,,0,0,0,0
Indian Summer,,0,0,0,0
Made in America,1 win & 1 nomination.,0,1,1,2
Leprechaun,1 win & 1 nomination.,0,1,1,2
Mad Dog and Glory,2 nominations.,0,0,2,2
Indecent Proposal,7 wins & 8 nominations,0,7,8,15
Homeward Bound: The Incredible Journey,1 nomination,0,0,1,1
In the Line of Fire,Nominated for 3 Oscars. Another 2 wins & 14 nominations.,3,2,14,19
Jack the Bear,1 win & 3 nominations.,0,1,3,4
Hard Target,1 win & 5 nominations.,0,1,5,6
Last Action Hero,1 win & 16 nominations,0,1,16,17
El Mariachi,7 wins & 4 nominations.,0,7,4,11
Rich in Love,,0,0,0,0
The Mighty Ducks,2 nominations.,0,0,2,2
Radio Flyer,1 win & 2 nominations.,0,1,2,3
Home Alone 2: Lost in New York,3 wins & 3 nominations.,0,3,3,6
White Sands,,0,0,0,0
Roadside Prophets,,0,0,0,0
House of Angels,7 wins & 3 nominations.,0,7,3,10
The Public Eye,,0,0,0,0
HouseSitter,,0,0,0,0
Prelude to a Kiss,,0,0,0,0
Romper Stomper,8 wins & 7 nominations.,0,8,7,15
A League of Their Own,6 wins & 13 nominations.,0,6,13,19
A Few Good Men,Nominated for 4 Oscars. Another 10 wins & 26 nominations.,4,10,26,40
Whispers in the Dark,1 nomination.,0,0,1,1
The Power of One,1 win & 4 nominations.,0,1,4,5
White Men Can't Jump,4 nominations.,0,0,4,4
Raising Cain,5 nominations.,0,0,5,5
Rapid Fire,,0,0,0,0
Belle Epoque,Won 1 Oscar. Another 24 wins & 15 nominations.,1,24,15,40
Honey I Blew Up the Kid,10 nominations,0,0,10,10
The Opposite Sex and How to Live with Them,,0,0,0,0
Pure Country,,0,0,0,0
Howards End,Won 3 Oscars. Another 29 wins & 49 nominations.,3,29,49,81
Beethoven,1 win & 4 nominations.,0,1,4,5
Encino Man,1 win & 1 nomination.,0,1,1,2
The Playboys,1 win.,0,1,0,1
Honeymoon in Vegas,Nominated for 2 Golden Globes. Another 2 nominations.,0,0,4,4
Kuffs,1 win & 1 nomination.,0,1,1,2
The Player,Nominated for 3 Oscars. Another 24 wins & 30 nominations.,3,24,30,57
Reservoir Dogs,12 wins & 23 nominations.,0,12,23,35
The Muppet Christmas Carol,2 wins & 1 nomination.,0,2,1,3
Big Girls Don't Cry... They Get Even,,0,0,0,0
Man Bites Dog,6 wins & 5 nominations.,0,6,5,11
Ruby,,0,0,0,0
Boomerang,1 win & 5 nominations,0,1,5,6
Diggstown,,0,0,0,0
Sidekicks,,0,0,0,0
Year of the Comet,,0,0,0,0
Simple Men,2 nominations.,0,0,2,2
Single White Female,1 win & 1 nomination.,0,1,1,2
Singles,1 win & 3 nominations.,0,1,3,4
3 Ninjas,1 nomination.,0,0,1,1
Sister Act,9 wins & 10 nominations,0,9,10,19
Zebrahead,2 wins & 5 nominations.,0,2,5,7
Ruby Cairo,,0,0,0,0
Sleepwalkers,5 wins.,0,5,0,5
1492: Conquista del Para�so,,0,0,0,0
In the Soup,5 wins & 3 nominations.,0,5,3,8
Sneakers,2 nominations,0,0,2,2
Into the Sun,,0,0,0,0
Brain Donors,,0,0,0,0
Bram Stoker's Dracula,,0,0,0,0
Deep Cover,4 nominations.,0,0,4,4
Indochine,Won 1 Oscar. Another 11 wins & 13 nominations.,1,11,13,25
Bob Roberts,Nominated for 1 Golden Globe. Another 4 wins & 2 nominations.,0,4,3,7
Jennifer 8,5 wins.,0,5,0,5
Shining Through,5 wins & 2 nominations,0,5,2,7
Shadow of the Wolf,2 wins & 2 nominations.,0,2,2,4
The Mambo Kings,Nominated for 1 Oscar. Another 5 nominations.,1,0,5,6
Wind,,0,0,0,0
The Lover,Nominated for 1 Oscar. Another 3 wins & 6 nominations.,1,3,6,10
The Long Day Closes,2 wins & 1 nomination.,0,2,1,3
Husbands and Wives,Nominated for 2 Oscars. Another 12 wins & 15 nominations.,2,12,15,29
Poison Ivy,2 nominations.,0,0,2,2
Just Another Girl on the I.R.T.,2 wins & 3 nominations.,0,2,3,5
Sarafina!,3 nominations.,0,0,3,3
Dr. Giggles,1 win & 2 nominations.,0,1,2,3
The Lawnmower Man,3 nominations.,0,0,3,3
The Last of the Mohicans,Won 1 Oscar. Another 6 wins & 17 nominations.,1,6,17,24
Scent of a Woman,Won 1 Oscar. 6 wins & 14 nominations total,1,6,14,21
Juice,1 nomination.,0,0,1,1
School Ties,3 nominations.,0,0,3,3
Blame It on the Bellboy,,0,0,0,0
Juego a muerte,,0,0,0,0
Batman Returns,Nominated for 2 Oscars. Another 2 wins & 27 nominations.,2,2,27,31
Leaving Normal,,0,0,0,0
Ladybugs,3 nominations.,0,0,3,3
Tokyo Decadence,1 win.,0,1,0,1
Unlawful Entry,1 nomination.,0,0,1,1
Mr. Baseball,1 nomination.,0,0,1,1
Luna amarga,,0,0,0,0
Used People,Nominated for 2 Golden Globes. Another 2 nominations.,0,0,4,4
Aces: Iron Eagle III,,0,0,0,0
Thunderheart,2 nominations.,0,0,2,2
Mr. Saturday Night,Nominated for 1 Oscar. Another 7 nominations.,1,0,7,8
Love Potion No. 9,,0,0,0,0
Love Field,Nominated for 1 Oscar. Another 1 win & 3 nominations.,1,1,3,5
Love Crimes,1 nomination.,0,0,1,1
Lorenzo's Oil,Nominated for 2 Oscars. Another 6 nominations.,2,0,6,8
This Is My Life,3 nominations.,0,0,3,3
My Cousin Vinny,Won 1 Oscar. Another 4 wins & 6 nominations.,1,4,6,11
My New Gun,1 nomination.,0,0,1,1
"Gas, Food Lodging",4 wins & 6 nominations.,0,4,6,10
Naked Killer,1 nomination.,0,0,1,1
The Hand That Rocks the Cradle,6 wins & 6 nominations.,0,6,6,12
Nemesis,,0,0,0,0
Glengarry Glen Ross,Nominated for 1 Oscar. Another 8 wins & 12 nominations.,1,8,12,21
Mom and Dad Save the World,1 nomination.,0,0,1,1
Night and the City,,0,0,0,0
Mo' Money,1 win.,0,1,0,1
Alien 3,,0,0,0,0
Aladdin,Won 2 Oscars. Another 31 wins & 22 nominations.,2,31,22,55
Malcolm X,Nominated for 2 Oscars. Another 19 wins & 22 nominations.,2,19,22,43
Under Siege,Nominated for 2 Oscars. Another 3 wins & 1 nomination.,2,3,1,6
Map of the Human Heart,3 wins & 8 nominations.,0,3,8,11
Twin Peaks: Fire Walk with Me,4 wins & 7 nominations.,0,4,7,11
Twin Dragons,1 nomination.,0,0,1,1
Guncrazy,Nominated for 1 Golden Globe. Another 1 win & 1 nomination.,0,1,2,3
Medicine Man,1 nomination.,0,0,1,1
Unforgiven,Won 4 Oscars. 50 wins & 47 nominations total,4,50,47,101
American Heart,1 win & 4 nominations.,0,1,4,5
Memoirs of an Invisible Man,5 nominations.,0,0,5,5
American Me,1 nomination.,0,0,1,1
Mac,1 win & 2 nominations.,0,1,2,3
Universal Soldier,,0,0,0,0
Traces of Red,1 nomination.,0,0,1,1
Toys,Nominated for 2 Oscars. Another 10 nominations.,2,0,10,12
Mistress,,0,0,0,0
Newsies,1 win & 6 nominations.,0,1,6,7
The Waterdance,5 wins & 5 nominations.,0,5,5,10
Hold Me Thrill Me Kiss Me,1 win & 1 nomination.,0,1,1,2
A Place in the World,Nominated for 1 Oscar. Another 16 wins & 6 nominations.,1,16,6,23
Final Analysis,1 win & 4 nominations.,0,1,4,5
Bad Lieutenant,2 wins & 5 nominations.,0,2,5,7
Fifty/Fifty,,0,0,0,0
Passed Away,1 nomination.,0,0,1,1
Passenger 57,,0,0,0,0
Passion Fish,Nominated for 2 Oscars. Another 2 wins & 9 nominations.,2,2,9,13
FernGully: Las aventuras de Zak y Crysta,,0,0,0,0
City of Joy,1 nomination.,0,0,1,1
Lethal Weapon 3,3 wins & 4 nominations,0,3,4,7
Bajos instintos,,0,0,0,0
Waterland,1 win & 1 nomination.,0,1,1,2
Wayne's World,4 wins & 5 nominations.,0,4,5,9
Man Trouble,1 nomination.,0,0,1,1
Leap of Faith,,0,0,0,0
Pet Sematary II,3 nominations.,0,0,3,3
Peter's Friends,4 wins & 3 nominations.,0,4,3,7
A Midnight Clear,1 nomination.,0,0,1,1
Laws of Gravity,3 wins & 7 nominations.,0,3,7,10
Hoffa,Nominated for 2 Oscars. Another 2 wins & 4 nominations.,2,2,4,8
Far and Away,3 nominations,0,0,3,3
Out on a Limb,1 win.,0,1,0,1
The Story of Qiu Ju,20 wins & 10 nominations.,0,20,10,30
Freejack,3 nominations.,0,0,3,3
Orlando,Nominated for 2 Oscars. Another 15 wins & 9 nominations.,2,15,9,26
Army of Darkness,12 wins & 7 nominations.,0,12,7,19
Article 99,,0,0,0,0
No Place to Hide,,0,0,0,0
Freddie as F.R.O.7.,,0,0,0,0
Noises Off...,1 win.,0,1,0,1
Fortress,2 nominations.,0,0,2,2
Hellraiser III: Hell on Earth,1 win & 10 nominations.,0,1,10,11
Forever Young,,0,0,0,0
The Tom and Jerry Movie,,0,0,0,0
A Stranger Among Us,1 win & 3 nominations.,0,1,3,4
Of Mice and Men,1 nomination.,0,0,1,1
Light Sleeper,1 win & 6 nominations.,0,1,6,7
"Olivier, Olivier",2 wins & 3 nominations.,0,2,3,5
Once Upon a Crime...,1 nomination.,0,0,1,1
Folks!,1 nomination.,0,0,1,1
One False Move,8 wins & 8 nominations.,0,8,8,16
A River Runs Through It,Won 1 Oscar. Another 3 wins & 11 nominations.,1,3,11,15
Patriot Games,1 win & 3 nominations,0,1,3,4
Innocent Blood,6 nominations.,0,0,6,6
Supercop,2 wins & 4 nominations.,0,2,4,6
Class Act,,0,0,0,0
Christopher Columbus: The Discovery,2 wins & 6 nominations.,0,2,6,8
Dead Alive,14 wins & 7 nominations.,0,14,7,21
Candyman,5 wins & 10 nominations.,0,5,10,15
B�b�'s Kids,,0,0,0,0
The Cutting Edge,,0,0,0,0
Death Becomes Her,Won 1 Oscar. Another 4 wins & 16 nominations.,1,4,16,21
The Efficiency Expert,3 wins & 7 nominations.,0,3,7,10
Split Second,,0,0,0,0
The Bodyguard,Nominated for 2 Oscars. Another 10 wins & 19 nominations.,2,10,19,31
Children of the Corn II: The Final Sacrifice,1 nomination.,0,0,1,1
Consenting Adults,1 nomination.,0,0,1,1
Damage,Nominated for 1 Oscar. Another 6 wins & 4 nominations.,1,6,4,11
Stay Tuned,2 nominations.,0,0,2,2
The Crying Game,Won 1 Oscar. Another 21 wins & 46 nominations.,1,21,46,68
Captain Ron,2 nominations.,0,0,2,2
Crossing the Bridge,,0,0,0,0
That Night,,0,0,0,0
Cool World,2 nominations,0,0,2,2
Tetsuo II: Body Hammer,3 wins & 2 nominations.,0,3,2,5
The Babe,1 nomination.,0,0,1,1
Strictly Ballroom,Won 3 BAFTA Film Awards. Another 16 wins & 18 nominations.,0,19,18,37
Como agua para chocolate,Nominated for 1 Golden Globe. Another 26 wins & 12 nominations.,0,26,13,39
Straight Talk,,0,0,0,0
Storyville,1 nomination.,0,0,1,1
Chaplin,Nominated for 3 Oscars. Another 3 wins & 16 nominations.,3,3,16,22
Stop! Or My Mom Will Shoot,3 wins & 1 nomination.,0,3,1,4
CrissCross,,0,0,0,0
The Gun in Betty Lou's Handbag,,0,0,0,0
The Distinguished Gentleman,4 wins,0,4,0,4
South Central,3 nominations.,0,0,3,3
The Taking of Beverly Hills,,0,0,0,0
Curly Sue,1 win.,0,1,0,1
Dead Again,Nominated for 1 Golden Globe. Another 1 win & 4 nominations.,0,1,5,6
The Silence of the Lambs,Won 5 Oscars. Another 64 wins & 51 nominations.,5,64,51,120
Paradise,,0,0,0,0
Cape Fear,Nominated for 2 Oscars. Another 5 wins & 19 nominations.,2,5,19,26
Terminator 2: Judgment Day,Won 4 Oscars. Another 32 wins & 33 nominations.,4,32,33,69
Wild Hearts Can't Be Broken,,0,0,0,0
The Ballad of the Sad Cafe,1 nomination.,0,0,1,1
Under Suspicion,2 nominations.,0,0,2,2
A Kiss Before Dying,2 wins.,0,2,0,2
Whore,,0,0,0,0
Hard Promises,,0,0,0,0
Once Around,1 nomination.,0,0,1,1
One Good Cop,1 nomination.,0,0,1,1
Wild Orchid II: Two Shades of Blue,,0,0,0,0
The Man in the Moon,3 nominations.,0,0,3,3
Black Robe,10 wins & 13 nominations.,0,10,13,23
Scenes from a Mall,,0,0,0,0
Dutch,1 win & 1 nomination.,0,1,1,2
Homicide,3 wins & 7 nominations.,0,3,7,10
Dying Young,3 nominations.,0,0,3,3
Married to It,,0,0,0,0
Bugsy,Won 2 Oscars. Another 10 wins & 41 nominations.,2,10,41,53
Suburban Commando,,0,0,0,0
The Marrying Man,1 nomination.,0,0,1,1
Hook,Nominated for 5 Oscars. Another 7 wins & 17 nominations.,5,7,17,29
Where the Day Takes You,1 win & 2 nominations.,0,1,2,3
Run,3 wins & 4 nominations.,0,3,4,7
Only the Lonely,,0,0,0,0
The Super,1 win.,0,1,0,1
King Ralph,,0,0,0,0
Samantha,1 win.,0,1,0,1
Flirting,5 wins & 3 nominations.,0,5,3,8
Oscar,3 nominations.,0,0,3,3
Other People's Money,,0,0,0,0
Mannequin: On the Move,,0,0,0,0
Closet Land,1 win & 1 nomination.,0,1,1,2
Out for Justice,,0,0,0,0
Teenage Mutant Ninja Turtles II: The Secret of the Ooze,2 wins & 1 nomination.,0,2,1,3
Drop Dead Fred,,0,0,0,0
House Party 2,,0,0,0,0
Flight of the Intruder,,0,0,0,0
Hangin' with the Homeboys,2 wins & 8 nominations.,0,2,8,10
Where Angels Fear to Tread,1 win.,0,1,0,1
Only Yesterday,,0,0,0,0
Harley Davidson and the Marlboro Man,1 nomination.,0,0,1,1
White Fang,1 win.,0,1,0,1
Bingo,2 nominations.,0,0,2,2
Hot Shots!,1 win.,0,1,0,1
Backdraft,Nominated for 3 Oscars. Another 1 win & 8 nominations.,3,1,8,12
Billy Bathgate,Nominated for 1 Golden Globe. Another 2 nominations.,0,0,3,3
Bill & Ted's Bogus Journey,,0,0,0,0
Star Trek VI: The Undiscovered Country,Nominated for 2 Oscars. Another 2 wins & 7 nominations.,2,2,7,11
The Lovers on the Bridge,Nominated for 1 BAFTA Film Award. Another 5 wins & 10 nominations.,0,5,11,16
L.A. Story,1 nomination,0,0,1,1
Madame Bovary,2 nominations.,0,0,2,2
City of Hope,5 wins & 4 nominations.,0,5,4,9
Cool as Ice,1 win & 7 nominations.,0,1,7,8
Becoming Colette,,0,0,0,0
The Prince of Tides,Nominated for 7 Oscars. Another 3 wins & 11 nominations.,7,3,11,21
The Commitments,Nominated for 1 Oscar. Another 11 wins & 12 nominations.,1,11,12,24
Eve of Destruction,,0,0,0,0
Rapsodia en agosto,,0,0,0,0
Life Stinks,,0,0,0,0
Liebestraum,,0,0,0,0
Prospero's Books,Nominated for 1 BAFTA Film Award. Another 3 wins & 4 nominations.,0,3,5,8
The Princess and the Goblin,,0,0,0,0
Stepping Out,,0,0,0,0
Enchanted April,Nominated for 3 Oscars. Another 4 wins & 6 nominations.,3,4,6,13
London Kills Me,,0,0,0,0
Straight Out of Brooklyn,4 wins & 5 nominations.,0,4,5,9
Rambling Rose,Nominated for 2 Oscars. Another 6 wins & 13 nominations.,2,6,13,21
Stone Cold,1 nomination.,0,0,1,1
What About Bob?,2 wins & 2 nominations.,0,2,2,4
The Pit and the Pendulum,1 win & 5 nominations.,0,1,5,6
Little Man Tate,2 wins & 1 nomination.,0,2,1,3
The Perfect Weapon,,0,0,0,0
Queens Logic,1 nomination.,0,0,1,1
Pure Luck,,0,0,0,0
Cabeza de Vaca,2 wins & 5 nominations.,0,2,5,7
Punto de quiebra,,0,0,0,0
Voyager,4 wins & 4 nominations.,0,4,4,8
Europa,18 wins & 9 nominations.,0,18,9,27
The People Under the Stairs,2 wins & 7 nominations.,0,2,7,9
Timebomb,1 win.,0,1,0,1
Company Business,,0,0,0,0
The Pope Must Diet,1 nomination,0,0,1,1
Livin' Large!,,0,0,0,0
Raise the Red Lantern,Nominated for 1 Oscar. Another 24 wins & 14 nominations.,1,24,14,39
Beauty and the Beast,Won 2 Oscars. Another 30 wins & 32 nominations.,2,30,32,64
The Object of Beauty,,0,0,0,0
Regarding Henry,1 win & 2 nominations.,0,1,2,3
Highlander II: The Quickening,,0,0,0,0
V.I. Warshawski,1 nomination.,0,0,1,1
Barton Fink,Nominated for 3 Oscars. Another 19 wins & 27 nominations.,3,19,27,49
Lovers: A True Story,14 wins & 9 nominations.,0,14,9,23
Ricochet,,0,0,0,0
"He Said, She Said",,0,0,0,0
Until the End of the World,3 wins & 2 nominations.,0,3,2,5
Problem Child 2,3 nominations.,0,0,3,3
Edward II,5 wins & 2 nominations,0,5,2,7
Late for Dinner,,0,0,0,0
Father of the Bride,1 win & 4 nominations.,0,1,4,5
Robin Hood: Prince of Thieves,Nominated for 1 Oscar. Another 16 wins & 23 nominations.,1,16,23,40
Strictly Business,,0,0,0,0
High Heels,1 win.,0,1,0,1
Hear My Song,Nominated for 1 Golden Globe. Another 4 wins & 3 nominations.,0,4,4,8
The Rocketeer,1 win & 6 nominations.,0,1,6,7
Return to the Blue Lagoon,6 nominations.,0,0,6,6
Poison,4 wins & 6 nominations.,0,4,6,10
The Addams Family,Nominated for 1 Oscar. Another 5 wins & 20 nominations.,1,5,20,26
The Adjuster,5 wins & 2 nominations.,0,5,2,7
Popcorn,,0,0,0,0
The Naked Gun 2�: The Smell of Fear,,0,0,0,0
F/X2,,0,0,0,0
The Fisher King,Won 1 Oscar. Another 13 wins & 38 nominations.,1,13,38,52
Child's Play 3,1 win & 3 nominations.,0,1,3,4
The Five Heartbeats,1 win & 1 nomination.,0,1,1,2
Van Gogh,3 wins & 13 nominations.,0,3,13,16
The Rapture,4 nominations.,0,0,4,4
Beastmaster 2: Through the Portal of Time,,0,0,0,0
A Rage in Harlem,1 nomination.,0,0,1,1
Highway 61,3 wins & 4 nominations.,0,3,4,7
Ernest Scared Stupid,,0,0,0,0
For the Boys,Nominated for 1 Oscar. Another 1 win & 2 nominations.,1,1,2,4
The Butcher's Wife,1 nomination.,0,0,1,1
The Inner Circle,12 nominations.,0,0,12,12
Mississippi Masala,5 wins & 3 nominations.,0,5,3,8
Johnny Stecchino,5 wins & 3 nominations.,0,5,3,8
City Slickers,Won 1 Oscar. Another 7 wins & 7 nominations.,1,7,7,15
Sleeping with the Enemy,2 wins & 4 nominations.,0,2,4,6
Impromptu,1 win & 1 nomination.,0,1,1,2
My Heroes Have Always Been Cowboys,1 nomination.,0,0,1,1
My Girl,2 wins & 5 nominations.,0,2,5,7
JFK,Won 2 Oscars. Another 17 wins & 43 nominations.,2,17,43,62
Night on Earth,1 win & 2 nominations.,0,1,2,3
Delirious,,0,0,0,0
Career Opportunities,,0,0,0,0
Armour of God 2: Operation Condor,,0,0,0,0
Meeting Venus,3 wins & 2 nominations.,0,3,2,5
The Doctor,3 nominations.,0,0,3,3
True Colors,,0,0,0,0
Shattered,,0,0,0,0
Shakes the Clown,1 nomination.,0,0,1,1
Jungle Fever,6 wins & 9 nominations,0,6,9,15
Crooked Hearts,,0,0,0,0
Delicatessen,Nominated for 1 BAFTA Film Award. Another 15 wins & 15 nominations.,0,15,16,31
Mediterraneo,Won 1 Oscar. Another 8 wins & 17 nominations.,1,8,17,26
Defenseless,,0,0,0,0
Fried Green Tomatoes,Nominated for 2 Oscars. Another 6 wins & 12 nominations.,2,6,12,20
29th Street,,0,0,0,0
Shout,3 nominations.,0,0,3,3
Toy Soldiers,1 nomination.,0,0,1,1
The Double Life of Veronique,11 wins & 12 nominations.,0,11,12,23
Naked Lunch,13 wins & 18 nominations.,0,13,18,31
Talkin' Dirty After Dark,,0,0,0,0
Switch,3 nominations.,0,0,3,3
Another You,,0,0,0,0
If Looks Could Kill,3 nominations.,0,0,3,3
Thelma & Louise,15 wins & 46 nominations.,0,15,46,61
Mystery Date,,0,0,0,0
Necessary Roughness,,0,0,0,0
Grand Canyon,Nominated for 1 Oscar. Another 3 wins & 6 nominations.,1,3,6,10
Year of the Gun,1 nomination.,0,0,1,1
The Indian Runner,1 win & 1 nomination.,0,1,1,2
Toto the Hero,Nominated for 1 BAFTA Film Award. Another 16 wins & 3 nominations.,0,16,4,20
Amigos inseparables,,0,0,0,0
Scissors,,0,0,0,0
My Own Private Idaho,12 wins & 10 nominations.,0,12,10,22
The Doors,3 nominations.,0,0,3,3
New Jack City,1 win & 5 nominations.,0,1,5,6
Body Parts,2 wins & 6 nominations.,0,2,6,8
Slacker,1 win & 3 nominations.,0,1,3,4
Showdown in Little Tokyo,,0,0,0,0
Shadows and Fog,1 win & 2 nominations.,0,1,2,3
Freddy's Dead: The Final Nightmare,1 win & 4 nominations.,0,1,4,5
True Identity,,0,0,0,0
Double Impact,2 nominations.,0,0,2,2
Kafka,3 wins & 2 nominations.,0,3,2,5
Don't Tell Mom the Babysitter's Dead,4 nominations.,0,0,4,4
McBain,,0,0,0,0
The Knife,1 win & 1 nomination.,0,1,1,2
Talent for the Game,,0,0,0,0
An American Tail: Fievel Goes West,,0,0,0,0
Nothing But Trouble,2 wins & 6 nominations.,0,2,6,8
Hudson Hawk,3 wins & 5 nominations.,0,3,5,8
Soapdish,,0,0,0,0
The Hard Way,1 nomination.,0,0,1,1
The Last Boy Scout,2 nominations.,0,0,2,2
Mortal Thoughts,1 win & 1 nomination.,0,1,1,2
At Play in the Fields of the Lord,Nominated for 1 Golden Globe. Another 1 win & 1 nomination.,0,1,2,3
Twenty-One,3 nominations.,0,0,3,3
Kickboxer 2: The Road Back,,0,0,0,0
All I Want for Christmas,3 nominations.,0,0,3,3
Close My Eyes,4 wins.,0,4,0,4
Deceived,,0,0,0,0
Frankie and Johnny,Nominated for 1 Golden Globe. Another 4 wins & 1 nomination.,0,4,2,6
Not Without My Daughter,2 wins & 1 nomination.,0,2,1,3
Dogfight,1 nomination.,0,0,1,1
Mobsters,2 nominations.,0,0,2,2
Doc Hollywood,,0,0,0,0
Guilty by Suspicion,2 wins & 2 nominations.,0,2,2,4
Thousand Pieces of Gold,1 win & 1 nomination.,0,1,1,2
Sex and Zen,,0,0,0,0
Defending Your Life,5 nominations.,0,0,5,5
K2,,0,0,0,0
And You Thought Your Parents Were Weird,4 nominations.,0,0,4,4
Class Action,1 nomination.,0,0,1,1
The Hitman,,0,0,0,0
Boyz n the Hood,Nominated for 2 Oscars. Another 12 wins & 21 nominations.,2,12,21,35
Taking Care of Business,,0,0,0,0
Love & Murder,2 wins & 1 nomination.,0,2,1,3
The Rescuers Down Under,6 wins.,0,6,0,6
Misery,Won 1 Oscar. Another 4 wins & 10 nominations.,1,4,10,15
Mo' Better Blues,1 win & 3 nominations.,0,1,3,4
Vital Signs,,0,0,0,0
Mr. & Mrs. Bridge,9 wins & 18 nominations.,0,9,18,27
Mr. Destiny,,0,0,0,0
The Return of Superfly,,0,0,0,0
Angel Town,,0,0,0,0
Dances with Wolves,Won 7 Oscars. Another 44 wins & 38 nominations.,7,44,38,89
Goodfellas,Won 1 Oscar. Another 43 wins & 38 nominations.,1,43,38,82
The First Power,,0,0,0,0
Mindwalk,1 nomination.,0,0,1,1
Mountains of the Moon,1 win.,0,1,0,1
Another 48 Hrs.,,0,0,0,0
The Forbidden Dance,1 nomination.,0,0,1,1
Europa Europa,Nominated for 1 Oscar. Another 8 wins & 7 nominations.,1,8,7,16
Predator 2,1 win & 4 nominations.,0,1,4,5
Postcards from the Edge,Nominated for 2 Oscars. Another 2 wins & 10 nominations.,2,2,10,14
My Father's Glory,2 wins & 4 nominations.,0,2,4,6
Everybody Wins,1 nomination.,0,0,1,1
Mister Johnson,1 win & 1 nomination.,0,1,1,2
Look Who's Talking Too,3 nominations.,0,0,3,3
Tales from the Darkside: The Movie,1 win.,0,1,0,1
Loose Cannons,29 wins & 24 nominations.,0,29,24,53
Vincent & Theo,1 win.,0,1,0,1
Problem Child,1 nomination.,0,0,1,1
Heaven and Earth,1 win & 6 nominations.,0,1,6,7
My Mother's Castle,1 win & 5 nominations.,0,1,5,6
Ghost Dad,3 nominations.,0,0,3,3
Lord of the Flies,3 nominations.,0,0,3,3
My Blue Heaven,,0,0,0,0
Gate 2: The Trespassers,,0,0,0,0
An Angel at My Table,18 wins & 4 nominations.,0,18,4,22
The Adventures of Ford Fairlane,5 wins & 3 nominations.,0,5,3,8
Ghost,Won 2 Oscars. Another 16 wins & 23 nominations.,2,16,23,41
Pretty Woman,Nominated for 1 Oscar. Another 8 wins & 10 nominations.,1,8,10,19
Presumed Innocent,1 win & 2 nominations.,0,1,2,3
To Sleep with Anger,7 wins & 10 nominations.,0,7,10,17
Miami Blues,2 wins & 2 nominations.,0,2,2,4
Heart Condition,,0,0,0,0
Love at Large,,0,0,0,0
Ultra Warrior,,0,0,0,0
Courage Mountain,,0,0,0,0
Alice,Nominated for 1 Oscar. Another 1 win & 6 nominations.,1,1,6,8
Back to the Future Part III,5 wins & 11 nominations.,0,5,11,16
Truly Madly Deeply,Won 1 BAFTA Film Award. Another 16 wins & 7 nominations.,0,17,7,24
Happily Ever After,,0,0,0,0
Coupe de Ville,,0,0,0,0
Flatliners,Nominated for 1 Oscar. Another 2 nominations.,1,0,2,3
Flashback,,0,0,0,0
Pacific Heights,,0,0,0,0
Crossing the Line,,0,0,0,0
Meet the Applegates,,0,0,0,0
Gremlins 2: The New Batch,6 nominations.,0,0,6,6
Memphis Belle,Nominated for 1 BAFTA Film Award. Another 1 win & 3 nominations.,0,1,4,5
The Two Jakes,,0,0,0,0
Auntie Danielle,3 nominations.,0,0,3,3
Cry-Baby,,0,0,0,0
Avalon,4 wins & 1 nomination.,0,4,1,5
The Exorcist III,2 wins & 5 nominations.,0,2,5,7
Marked for Death,,0,0,0,0
Nuns on the Run,,0,0,0,0
Awakenings,Nominated for 3 Oscars. Another 6 wins & 8 nominations.,3,6,8,17
Tune in Tomorrow...,2 wins.,0,2,0,2
The End of Innocence,,0,0,0,0
Two Evil Eyes,2 nominations.,0,0,2,2
May Fools,Nominated for 1 BAFTA Film Award. Another 2 wins & 6 nominations.,0,2,7,9
Q & A,,0,0,0,0
Almost an Angel,,0,0,0,0
Frankenhooker,,0,0,0,0
Fire Birds,,0,0,0,0
Nightbreed,7 wins & 4 nominations.,0,7,4,11
Bad Influence,1 win & 1 nomination.,0,1,1,2
Funny About Love,,0,0,0,0
Crazy People,,0,0,0,0
"After Dark, My Sweet",1 nomination.,0,0,1,1
Streets,,0,0,0,0
Havana,Nominated for 1 Oscar. Another 2 nominations.,1,0,2,3
The Witches,Nominated for 1 BAFTA Film Award. Another 3 wins & 7 nominations.,0,3,8,11
The Field,Nominated for 1 Oscar. Another 3 nominations.,1,0,3,4
Graveyard Shift,1 nomination.,0,0,1,1
Daddy's Dyin'... Who's Got the Will?,,0,0,0,0
Metropolitan,Nominated for 1 Oscar. Another 6 wins & 9 nominations.,1,6,9,16
Graffiti Bridge,1 win & 6 nominations.,0,1,6,7
Cadillac Man,,0,0,0,0
The Russia House,Nominated for 1 Golden Globe. Another 4 nominations.,0,0,5,5
Navy Seals,,0,0,0,0
Narrow Margin,1 nomination.,0,0,1,1
Miller's Crossing,4 wins & 16 nominations.,0,4,16,20
Cadence,1 nomination.,0,0,1,1
Texasville,,0,0,0,0
Mermaids,Nominated for 1 Golden Globe. Another 4 wins.,0,4,1,5
Cyrano de Bergerac,Won 1 Oscar. Another 30 wins & 29 nominations.,1,30,29,60
The Sheltering Sky,Won 1 Golden Globe. Another 8 wins & 8 nominations.,0,9,8,17
Night of the Living Dead,6 wins.,0,6,0,6
Men Don't Leave,3 nominations.,0,0,3,3
Madhouse,,0,0,0,0
The Shrimp on the Barbie,,0,0,0,0
Tremors,5 nominations.,0,0,5,5
Men at Work,,0,0,0,0
The Hairdresser's Husband,Nominated for 1 BAFTA Film Award. Another 1 win & 7 nominations.,0,1,8,9
American Ninja 4: The Annihilation,,0,0,0,0
Arachnophobia,2 wins & 5 nominations.,0,2,5,7
Hard to Kill,,0,0,0,0
Hardware,3 wins & 3 nominations.,0,3,3,6
Men of Respect,1 nomination.,0,0,1,1
Air America,1 nomination.,0,0,1,1
Strike It Rich,,0,0,0,0
Green Card,Nominated for 1 Oscar. Another 3 wins & 3 nominations.,1,3,3,7
Opportunity Knocks,,0,0,0,0
Pump Up the Volume,3 wins & 5 nominations.,0,3,5,8
Chicago Joe and the Showgirl,,0,0,0,0
DuckTales the Movie: Treasure of the Lost Lamp,1 nomination.,0,0,1,1
House Party,2 wins & 10 nominations.,0,2,10,12
Bird on a Wire,,0,0,0,0
The Long Walk Home,1 win & 2 nominations.,0,1,2,3
White Hunter Black Heart,2 nominations.,0,0,2,2
Dreams,3 wins & 12 nominations.,0,3,12,15
White Palace,Nominated for 1 Golden Globe. Another 1 win.,0,1,1,2
The Godfather: Part III,Nominated for 7 Oscars. Another 6 wins & 16 nominations.,7,6,16,29
A Cry in the Wild,1 nomination.,0,0,1,1
The Last of the Finest,1 nomination.,0,0,1,1
Downtown,,0,0,0,0
Stanley & Iris,,0,0,0,0
Wild at Heart,Nominated for 1 Oscar. Another 5 wins & 11 nominations.,1,5,11,17
The Krays,Nominated for 1 BAFTA Film Award. Another 4 wins & 1 nomination.,0,4,2,6
Ju Dou,Nominated for 1 Oscar. Another 10 wins & 2 nominations.,1,10,2,13
Darkman,3 wins & 8 nominations.,0,3,8,11
Days of Thunder,Nominated for 1 Oscar. Another 1 win & 1 nomination.,1,1,1,3
Come See the Paradise,3 nominations.,0,0,3,3
Reversal of Fortune,Won 1 Oscar. Another 12 wins & 16 nominations.,1,12,16,29
Leatherface: Texas Chainsaw Massacre III,1 nomination.,0,0,1,1
The Misadventures of Mr. Wilt,,0,0,0,0
"Welcome Home, Roxy Carmichael",,0,0,0,0
Edward Scissorhands,Nominated for 1 Oscar. Another 9 wins & 23 nominations.,1,9,23,33
Lambada,,0,0,0,0
RoboCop 2,3 nominations.,0,0,3,3
China Cry: A True Story,,0,0,0,0
Home Alone,Nominated for 2 Oscars. Another 11 wins & 4 nominations.,2,11,4,17
Rocky V,9 nominations.,0,0,9,9
Roger Corman's Frankenstein Unbound,4 nominations.,0,0,4,4
State of Grace,,0,0,0,0
Rosencrantz & Guildenstern Are Dead,3 wins & 2 nominations.,0,3,2,5
I Love You to Death,,0,0,0,0
Journey of Hope,Won 1 Oscar. Another 3 wins & 2 nominations.,1,3,2,6
Short Time,,0,0,0,0
Body Chemistry,,0,0,0,0
Spaced Invaders,,0,0,0,0
The Grifters,Nominated for 4 Oscars. Another 10 wins & 17 nominations.,4,10,17,31
Slumber Party Massacre III,,0,0,0,0
Delta Force 2: The Colombian Connection,,0,0,0,0
Class of 1999,1 nomination.,0,0,1,1
Brain Dead,,0,0,0,0
Def by Temptation,1 nomination.,0,0,1,1
The Haunting of Morella,,0,0,0,0
The Boyfriend School,,0,0,0,0
Internal Affairs,,0,0,0,0
Death Warrant,,0,0,0,0
Soultaker,1 win.,0,1,0,1
"�Ay, Carmela!",22 wins & 6 nominations.,0,22,6,28
The Hot Spot,,0,0,0,0
Desperate Hours,1 nomination.,0,0,1,1
Young Guns II,Nominated for 1 Oscar. Another 3 wins & 3 nominations.,1,3,3,7
Die Hard 2,1 win & 1 nomination.,0,1,1,2
Sibling Rivalry,,0,0,0,0
Joe Versus the Volcano,1 nomination.,0,0,1,1
"I, the Worst of All",4 wins & 1 nomination.,0,4,1,5
Jetsons: The Movie,1 nomination.,0,0,1,1
Side Out,,0,0,0,0
Dick Tracy,Won 3 Oscars. Another 6 wins & 36 nominations.,3,6,36,45
Ski Patrol,,0,0,0,0
Book of Love,1 nomination.,0,0,1,1
Jacob's Ladder,3 wins.,0,3,0,3
The Hunt for Red October,Won 1 Oscar. Another 2 wins & 8 nominations.,1,2,8,11
The Bonfire of the Vanities,1 win & 5 nominations.,0,1,5,6
3 Men and a Little Lady,,0,0,0,0
Hidden Agenda,2 wins & 3 nominations.,0,2,3,5
Kindergarten Cop,4 wins & 1 nomination.,0,4,1,5
El vengador del futuro,,0,0,0,0
The Fourth War,,0,0,0,0
El verdugo de Nueva York,,0,0,0,0
The Nasty Girl,Nominated for 1 Oscar. Another 11 wins & 5 nominations.,1,11,5,17
The NeverEnding Story II: The Next Chapter,2 wins & 4 nominations.,0,2,4,6
Lionheart,,0,0,0,0
The Comfort of Strangers,1 win.,0,1,0,1
Henry & June,,0,0,0,0
Ernest Goes to Jail,,0,0,0,0
Life Is Sweet,8 wins & 3 nominations.,0,8,3,11
A Tale of Springtime,,0,0,0,0
Betsy's Wedding,3 nominations.,0,0,3,3
Quigley Down Under,2 wins & 1 nomination.,0,2,1,3
Waiting for the Light,,0,0,0,0
The Freshman,1 win & 2 nominations.,0,1,2,3
Repossessed,1 win.,0,1,0,1
El pr�ncipe Cascanueces,,0,0,0,0
A Show of Force,,0,0,0,0
Child's Play 2,1 win.,0,1,0,1
Quick Change,,0,0,0,0
A Shock to the System,1 nomination.,0,0,1,1
She's Out of Control,1 win & 1 nomination.,0,1,1,2
Shag,2 nominations.,0,0,2,2
Do the Right Thing,Nominated for 2 Oscars. Another 21 wins & 15 nominations.,2,21,15,38
Gross Anatomy,,0,0,0,0
The Big Picture,,0,0,0,0
Always,3 nominations.,0,0,3,3
True Believer,1 win & 1 nomination.,0,1,1,2
Bloodhounds of Broadway,1 nomination.,0,0,1,1
The January Man,,0,0,0,0
A Nightmare on Elm Street 5: The Dream Child,3 wins & 2 nominations.,0,3,2,5
Troop Beverly Hills,,0,0,0,0
Disorganized Crime,,0,0,0,0
No Holds Barred,,0,0,0,0
Triumph of the Spirit,,0,0,0,0
Tap,1 nomination.,0,0,1,1
84C MoPic,3 nominations.,0,0,3,3
The War of the Roses,Nominated for 3 Golden Globes. Another 2 wins & 6 nominations.,0,2,9,11
Worth Winning,,0,0,0,0
Longtime Companion,Nominated for 1 Oscar. Another 6 wins & 5 nominations.,1,6,5,12
Shirley Valentine,Nominated for 2 Oscars. Another 4 wins & 7 nominations.,2,4,7,13
Blue Steel,2 wins & 1 nomination.,0,2,1,3
Shocker,1 nomination.,0,0,1,1
Tango & Cash,Nominated for 1 Oscar. Another 8 wins & 10 nominations.,1,8,10,19
She-Devil,,0,0,0,0
K-9,,0,0,0,0
Bloodfist,,0,0,0,0
Kill Me Again,1 win.,0,1,0,1
Sea of Love,4 nominations.,0,0,4,4
Dark Obsession,2 nominations.,0,0,2,2
Chances Are,Nominated for 1 Oscar. Another 1 win & 1 nomination.,1,1,1,3
The Toxic Avenger Part III: The Last Temptation of Toxie,1 nomination.,0,0,1,1
The Toxic Avenger Part II,1 nomination.,0,0,1,1
Cruising Bar,1 win & 3 nominations.,0,1,3,4
Crack House,,0,0,0,0
Martians Go Home,,0,0,0,0
Old Gringo,1 nomination.,0,0,1,1
How to Get Ahead in Advertising,,0,0,0,0
Scenes from the Class Struggle in Beverly Hills,1 win & 1 nomination.,0,1,1,2
Wild Orchid,2 nominations.,0,0,2,2
Chattahoochee,,0,0,0,0
Kickboxer,,0,0,0,0
Teen Witch,2 nominations.,0,0,2,2
Blaze,Nominated for 1 Oscar. Another 1 win & 2 nominations.,1,1,2,4
Second Sight,,0,0,0,0
Chameleon Street,1 win & 1 nomination.,0,1,1,2
"See No Evil, Hear No Evil",,0,0,0,0
See You in the Morning,,0,0,0,0
Look Who's Talking,5 wins & 2 nominations.,0,5,2,7
Blind Fury,,0,0,0,0
A Chorus of Disapproval,,0,0,0,0
Winter People,,0,0,0,0
Wired,,0,0,0,0
"Sex, Lies, and Videotape",Nominated for 1 Oscar. Another 15 wins & 23 nominations.,1,15,23,39
Cousins,,0,0,0,0
Dead Poets Society,Won 1 Oscar. Another 19 wins & 19 nominations.,1,19,19,39
The Unbelievable Truth,2 nominations.,0,0,2,2
The Karate Kid Part III,5 nominations.,0,0,5,5
Friday the 13th Part VIII: Jason Takes Manhattan,2 nominations.,0,0,2,2
American Ninja 3: Blood Hunt,,0,0,0,0
Sweetie,3 wins & 8 nominations.,0,3,8,11
Johnny Handsome,3 nominations.,0,0,3,3
My Left Foot,Won 2 Oscars. Another 21 wins & 20 nominations.,2,21,20,43
Erik the Viking,,0,0,0,0
Torrents of Spring,1 nomination.,0,0,1,1
In Country,,0,0,0,0
The Horror Show,1 nomination.,0,0,1,1
Little Nemo: Adventures in Slumberland,1 win & 1 nomination.,0,1,1,2
Little Monsters,3 wins & 10 nominations.,0,3,10,13
The Fly II,3 nominations.,0,0,3,3
Too Beautiful for You,6 wins & 7 nominations.,0,6,7,13
Music Box,Nominated for 1 Oscar. Another 1 win & 2 nominations.,1,1,2,4
Three Fugitives,1 nomination.,0,0,1,1
DeepStar Six,,0,0,0,0
Monsieur Hire,6 wins & 8 nominations.,0,6,8,14
Getting It Right,,0,0,0,0
Glory,Won 3 Oscars. Another 11 wins & 18 nominations.,3,11,18,32
Casualties of War,Nominated for 1 Golden Globe. Another 1 win & 4 nominations.,0,1,5,6
Indiana Jones and the Last Crusade,Won 1 Oscar. Another 7 wins & 22 nominations.,1,7,22,30
Breaking In,1 win & 1 nomination.,0,1,1,2
Gleaming the Cube,,0,0,0,0
Tie Me Up! Tie Me Down!,8 wins & 19 nominations.,0,8,19,27
Lisa,2 nominations.,0,0,2,2
Crimes and Misdemeanors,Nominated for 3 Oscars. Another 16 wins & 23 nominations.,3,16,23,42
Mortal Passions,2 nominations.,0,0,2,2
Listen to Me,1 win & 2 nominations.,0,1,2,3
Brenda Starr,,0,0,0,0
Ghostbusters II,2 wins & 1 nomination.,0,2,1,3
Queen of Hearts,24 wins & 19 nominations.,0,24,19,43
Slaves of New York,,0,0,0,0
Immediate Family,1 win & 2 nominations.,0,1,2,3
Born on the Fourth of July,Won 2 Oscars. Another 13 wins & 26 nominations.,2,13,26,41
Her Alibi,1 nomination.,0,0,1,1
Night Visitor,,0,0,0,0
Night Game,,0,0,0,0
Black Rain,Nominated for 2 Oscars. Another 1 win & 2 nominations.,2,1,2,5
Next of Kin,1 nomination.,0,0,1,1
"I, Madman",1 win & 1 nomination.,0,1,1,2
Licence to Kill,,0,0,0,0
New York Stories,1 win.,0,1,0,1
Great Balls of Fire!,1 win & 1 nomination.,0,1,1,2
Enemies: A Love Story,Nominated for 3 Oscars. Another 4 wins & 7 nominations.,3,4,7,14
Life and Nothing But,Won 1 BAFTA Film Award. Another 8 wins & 14 nominations.,0,9,14,23
Jesus of Montreal,Nominated for 1 Oscar. Another 18 wins & 11 nominations.,1,18,11,30
The Wizard,4 nominations.,0,0,4,4
Signs of Life,2 wins & 2 nominations.,0,2,2,4
National Lampoon's Christmas Vacation,,0,0,0,0
Hell High,,0,0,0,0
The Blood of Heroes,,0,0,0,0
The Package,1 win & 2 nominations.,0,1,2,3
The Dream Team,,0,0,0,0
Henry V,Won 1 Oscar. Another 10 wins & 13 nominations.,1,10,13,24
Jacknife,,0,0,0,0
Lock Up,3 nominations.,0,0,3,3
Cheetah,1 nomination.,0,0,1,1
Mystery Train,1 win & 8 nominations.,0,1,8,9
Miss Firecracker,1 nomination.,0,0,1,1
Skin Deep,,0,0,0,0
Halloween 5,1 win.,0,1,0,1
Turner & Hooch,,0,0,0,0
The Terror Within,,0,0,0,0
Romero,2 nominations.,0,0,2,2
Last Exit to Brooklyn,6 wins & 1 nomination.,0,6,1,7
Road House,5 nominations.,0,0,5,5
Edge of Sanity,,0,0,0,0
After Midnight,2 wins & 4 nominations.,0,2,4,6
Cookie,,0,0,0,0
Eddie and the Cruisers II: Eddie Lives!,1 nomination.,0,0,1,1
Stepfather II,,0,0,0,0
Robot Jox,1 nomination.,0,0,1,1
Harlem Nights,Nominated for 1 Oscar. Another 2 wins & 1 nomination.,1,2,1,4
Dad,Nominated for 1 Oscar. Another 2 wins & 4 nominations.,1,2,4,7
Field of Dreams,Nominated for 3 Oscars. Another 7 wins & 10 nominations.,3,7,10,20
Staying Together,1 win & 1 nomination.,0,1,1,2
Rooftops,1 nomination.,0,0,1,1
The Rainbow,1 nomination.,0,0,1,1
The Fabulous Baker Boys,Nominated for 4 Oscars. Another 14 wins & 13 nominations.,4,14,13,31
Rosalie Goes Shopping,1 win & 1 nomination.,0,1,1,2
Major League,1 nomination.,0,0,1,1
"Honey, I Shrunk the Kids",Won 1 BAFTA Film Award. Another 1 win & 10 nominations.,0,2,10,12
Parents,1 win & 2 nominations.,0,1,2,3
Parenthood,Nominated for 2 Oscars. Another 4 wins & 12 nominations.,2,4,12,18
Terror a bordo,,0,0,0,0
When Harry Met Sally...,Nominated for 1 Oscar. Another 4 wins & 16 nominations.,1,4,16,21
Uncle Buck,,0,0,0,0
Rude Awakening,,0,0,0,0
Fist Fighter,,0,0,0,0
Bill & Ted's Excellent Adventure,,0,0,0,0
The 'Burbs,1 nomination.,0,0,1,1
River of Death,,0,0,0,0
Pet Sematary,1 win & 5 nominations.,0,1,5,6
Fat Man and Little Boy,2 nominations.,0,0,2,2
The Return of Swamp Thing,1 win.,0,1,0,1
Valmont relaciones peligrosas,,0,0,0,0
Heart of Dixie,1 nomination.,0,0,1,1
Police Academy 6: City Under Siege,,0,0,0,0
Lethal Weapon 2,Nominated for 1 Oscar. Another 1 win & 1 nomination.,1,1,1,3
Bye Bye Blues,5 wins & 10 nominations.,0,5,10,15
Warlock,1 win & 7 nominations.,0,1,7,8
Let It Ride,,0,0,0,0
Strapless,,0,0,0,0
Batman,Won 1 Oscar. Another 8 wins & 26 nominations.,1,8,26,35
Family Business,,0,0,0,0
The Abyss,Won 1 Oscar. Another 8 wins & 15 nominations.,1,8,15,24
Lean on Me,4 wins & 5 nominations.,0,4,5,9
Loverboy,,0,0,0,0
We're No Angels,,0,0,0,0
Weekend at Bernie's,1 nomination.,0,0,1,1
Beverly Hills Brats,,0,0,0,0
Farewell to the King,,0,0,0,0
Welcome Home,,0,0,0,0
Fast Food,,0,0,0,0
Pink Cadillac,,0,0,0,0
Physical Evidence,1 win.,0,1,0,1
Powwow Highway,2 wins & 4 nominations.,0,2,4,6
Cage,,0,0,0,0
Prancer,2 nominations.,0,0,2,2
The Mighty Quinn,1 win & 2 nominations.,0,1,2,3
Steel Magnolias,Nominated for 1 Oscar. Another 2 wins & 6 nominations.,1,2,6,9
Lost Angels,1 nomination.,0,0,1,1
An Innocent Man,,0,0,0,0
Cyborg,,0,0,0,0
Dead Bang,,0,0,0,0
The Lemon Sisters,,0,0,0,0
The Experts,,0,0,0,0
Wicked Stepmother,1 nomination.,0,0,1,1
The Gods Must Be Crazy II,1 nomination.,0,0,1,1
The Rachel Papers,1 win.,0,1,0,1
Relentless,,0,0,0,0
Driving Miss Daisy,Won 4 Oscars. Another 17 wins & 24 nominations.,4,17,24,45
Communion,1 nomination.,0,0,1,1
Star Trek V: The Final Frontier,4 wins & 3 nominations.,0,4,3,7
All Dogs Go to Heaven,1 nomination.,0,0,1,1
UHF,,0,0,0,0
How I Got Into College,,0,0,0,0
"The Cook, the Thief, His Wife & Her Lover",7 wins & 11 nominations.,0,7,11,18
Renegades,1 win & 1 nomination.,0,1,1,2
Say Anything...,,0,0,0,0
Fletch Lives,,0,0,0,0
Dream a Little Dream,,0,0,0,0
The Little Mermaid,Won 2 Oscars. Another 12 wins & 8 nominations.,2,12,8,22
Kinjite: Forbidden Subjects,,0,0,0,0
A Dry White Season,Nominated for 1 Oscar. Another 2 wins & 7 nominations.,1,2,7,10
Best of the Best,1 nomination.,0,0,1,1
Who's Harry Crumb?,,0,0,0,0
Drugstore Cowboy,12 wins & 11 nominations.,0,12,11,23
The Tall Guy,,0,0,0,0
Cannonball Fever,,0,0,0,0
Back to the Future Part II,Nominated for 1 Oscar. Another 9 wins & 8 nominations.,1,9,8,18
"Bert Rigby, You're a Fool",1 nomination.,0,0,1,1
Jack's Back,1 nomination.,0,0,1,1
Mississippi Burning,Won 1 Oscar. Another 16 wins & 24 nominations.,1,16,24,41
Action Jackson,2 nominations.,0,0,2,2
Torch Song Trilogy,1 win & 3 nominations.,0,1,3,4
Willow,Nominated for 2 Oscars. Another 1 win & 9 nominations.,2,1,9,12
Little Nikita,,0,0,0,0
Iron Eagle II,3 nominations.,0,0,3,3
Coming to America,Nominated for 2 Oscars. Another 5 wins & 3 nominations.,2,5,3,10
Talk Radio,3 wins & 5 nominations.,0,3,5,8
Moon Over Parador,,0,0,0,0
Halloween 4: The Return of Michael Myers,1 win & 2 nominations.,0,1,2,3
Criminal Law,1 win.,0,1,0,1
Twins,Nominated for 1 Golden Globe. Another 4 wins.,0,4,1,5
A Cry in the Dark,Nominated for 1 Oscar. Another 8 wins & 11 nominations.,1,8,11,20
The Couch Trip,,0,0,0,0
Above the Law,1 nomination.,0,0,1,1
A Nightmare on Elm Street 4: The Dream Master,2 wins & 9 nominations.,0,2,9,11
Married to the Mob,Nominated for 1 Oscar. Another 6 wins & 4 nominations.,1,6,4,11
Masquerade,22 wins & 16 nominations.,0,22,16,38
The Accidental Tourist,Won 1 Oscar. Another 3 wins & 11 nominations.,1,3,11,15
Hellbound: Hellraiser II,1 win & 5 nominations.,0,1,5,6
A Night in the Life of Jimmy Reardon,1 nomination.,0,0,1,1
Clara's Heart,Nominated for 1 Golden Globe. Another 3 nominations.,0,0,4,4
Killer Klowns from Outer Space,2 nominations.,0,0,2,2
Waxwork,2 wins & 4 nominations.,0,2,4,6
Heart of Midnight,1 win.,0,1,0,1
Monkey Shines,7 wins & 1 nomination.,0,7,1,8
Colors,1 win & 1 nomination.,0,1,1,2
The Boost,1 nomination.,0,0,1,1
High Hopes,5 wins & 5 nominations.,0,5,5,10
18 Again!,,0,0,0,0
Last Rites,,0,0,0,0
1969,1 nomination.,0,0,1,1
Who Framed Roger Rabbit,Won 3 Oscars. Another 21 wins & 22 nominations.,3,21,22,46
Judgement in Berlin,,0,0,0,0
Tucker: The Man and His Dream,Nominated for 3 Oscars. Another 8 wins & 6 nominations.,3,8,6,17
License to Drive,2 wins & 1 nomination.,0,2,1,3
The Big Blue,3 wins & 6 nominations.,0,3,6,9
Messenger of Death,,0,0,0,0
Hero and the Terror,,0,0,0,0
Heathers,3 wins & 11 nominations.,0,3,11,14
The Dead Pool,,0,0,0,0
A World Apart,Won 1 BAFTA Film Award. Another 6 wins & 12 nominations.,0,7,12,19
I'm Gonna Git You Sucka,1 nomination.,0,0,1,1
Child's Play,2 wins & 3 nominations.,0,2,3,5
Johnny Be Good,1 nomination.,0,0,1,1
A Fish Called Wanda,Won 1 Oscar. Another 8 wins & 18 nominations.,1,8,18,27
Alien Nation,1 win & 4 nominations.,0,1,4,5
Without a Clue,1 win & 1 nomination.,0,1,1,2
The Chocolate War,2 nominations.,0,0,2,2
The Bear,Nominated for 1 Oscar. Another 5 wins & 10 nominations.,1,5,10,16
Clean and Sober,1 win.,0,1,0,1
976-EVIL,,0,0,0,0
Women on the Verge of a Nervous Breakdown,Nominated for 1 Oscar. Another 22 wins & 23 nominations.,1,22,23,46
Working Girl,Won 1 Oscar. Another 8 wins & 17 nominations.,1,8,17,26
Hot to Trot,5 nominations.,0,0,5,5
Akira,1 win.,0,1,0,1
Al borde del terror,,0,0,0,0
A Handful of Dust,Nominated for 1 Oscar. Another 3 wins & 3 nominations.,1,3,3,7
Memories of Me,,0,0,0,0
Tequila Sunrise,Nominated for 1 Oscar. Another 2 wins & 2 nominations.,1,2,2,5
Tapeheads,,0,0,0,0
The Beast of War,1 win.,0,1,0,1
Heartbreak Hotel,2 wins.,0,2,0,2
Young Guns,1 win & 2 nominations.,0,1,2,3
The Adventures of Baron Munchausen,Nominated for 4 Oscars. Another 11 wins & 10 nominations.,4,11,10,25
Luces de una gran ciudad,,0,0,0,0
Young Einstein,1 win & 3 nominations.,0,1,3,4
Kansas,,0,0,0,0
Miracle Mile,2 wins & 5 nominations.,0,2,5,7
Two Moon Junction,1 win.,0,1,0,1
Vice Versa,1 win.,0,1,0,1
The Deceivers,,0,0,0,0
Cocoon: The Return,4 nominations.,0,0,4,4
Illegally Yours,,0,0,0,0
Las travesuras de una pelirojja,,0,0,0,0
Track 29,1 win & 2 nominations.,0,1,2,3
Gorillas in the Mist,Nominated for 5 Oscars. Another 6 wins & 4 nominations.,5,6,4,15
Maniac Cop,,0,0,0,0
Vampire's Kiss,1 win & 2 nominations.,0,1,2,3
Miles from Home,1 nomination.,0,0,1,1
Midnight Run,2 wins & 4 nominations.,0,2,4,6
Vibes,,0,0,0,0
Mac and Me,2 wins & 6 nominations.,0,2,6,8
Cinema Paradiso,Won 1 Oscar. Another 24 wins & 32 nominations.,1,24,32,57
Cop,,0,0,0,0
Lady in White,1 win & 4 nominations.,0,1,4,5
The Blob,6 nominations.,0,0,6,6
Friday the 13th Part VII: The New Blood,4 nominations.,0,0,4,4
Moving,1 nomination.,0,0,1,1
Sunset,Nominated for 1 Oscar. Another 1 win & 1 nomination.,1,1,1,3
Running on Empty,Nominated for 2 Oscars. Another 5 wins & 6 nominations.,2,5,6,13
Off Limits,1 nomination.,0,0,1,1
For Queen & Country,2 wins.,0,2,0,2
Oliver & Company,,0,0,0,0
Big Top Pee-wee,1 nomination.,0,0,1,1
For Keeps?,1 win & 1 nomination.,0,1,1,2
Stars and Bars,1 win.,0,1,0,1
Big Business,1 win & 1 nomination.,0,1,1,2
Earth Girls Are Easy,3 nominations.,0,0,3,3
The Kiss,1 win.,0,1,0,1
Big,Nominated for 2 Oscars. Another 11 wins & 12 nominations.,2,11,12,25
Rocket Gibraltar,,0,0,0,0
Stealing Home,,0,0,0,0
Buster,Nominated for 1 Oscar. Another 4 wins.,1,4,0,5
Out of the Dark,,0,0,0,0
The Milagro Beanfield War,Won 1 Oscar. Another 1 win & 2 nominations.,1,1,2,4
Eight Men Out,2 nominations.,0,0,2,2
El Hotel de los Fantasmas,,0,0,0,0
Biloxi Blues,,0,0,0,0
Bird,Won 1 Oscar. Another 9 wins & 9 nominations.,1,9,9,19
The Lair of the White Worm,1 win & 3 nominations.,0,1,3,4
The Land Before Time,2 nominations.,0,0,2,2
The Good Mother,,0,0,0,0
Arthur 2: On the Rocks,1 win.,0,1,0,1
Scrooged,Nominated for 1 Oscar. Another 1 win & 4 nominations.,1,1,4,6
School Daze,1 nomination.,0,0,1,1
Bull Durham,Nominated for 1 Oscar. Another 7 wins & 5 nominations.,1,7,5,13
The Last Temptation of Christ,Nominated for 1 Oscar. Another 2 wins & 6 nominations.,1,2,6,9
Dead Heat,1 nomination.,0,0,1,1
The Unholy,,0,0,0,0
Salsa,1 nomination.,0,0,1,1
The Unbearable Lightness of Being,Nominated for 2 Oscars. Another 7 wins & 11 nominations.,2,7,11,20
Frantic,,0,0,0,0
Salome's Last Dance,,0,0,0,0
Not of This Earth,,0,0,0,0
The Moderns,2 wins & 5 nominations.,0,2,5,7
Return to Snowy River,2 nominations.,0,0,2,2
Paperhouse,3 wins & 1 nomination.,0,3,1,4
Phantasm II,2 nominations.,0,0,2,2
Escorpion rojo,,0,0,0,0
Beetlejuice,Won 1 Oscar. Another 6 wins & 11 nominations.,1,6,11,18
Bat*21,1 nomination.,0,0,1,1
Platoon Leader,,0,0,0,0
Stormy Monday,1 win & 2 nominations.,0,1,2,3
Punchline,1 win.,0,1,0,1
Pumpkinhead,3 nominations.,0,0,3,3
Police Academy 5: Assignment: Miami Beach,1 nomination.,0,0,1,1
Poltergeist III,2 nominations.,0,0,2,2
The Presidio,,0,0,0,0
The Rescue,1 nomination.,0,0,1,1
Beaches,Nominated for 1 Oscar. Another 1 win & 5 nominations.,1,1,5,7
Everybody's All-American,1 nomination.,0,0,1,1
Caddyshack II,4 wins & 2 nominations.,0,4,2,6
Ernest Saves Christmas,,0,0,0,0
Bad Dreams,,0,0,0,0
Rain Man,Won 4 Oscars. Another 22 wins & 23 nominations.,4,22,23,49
Return of the Living Dead II,3 nominations.,0,0,3,3
The Naked Gun: From the Files of Police Squad!,1 nomination.,0,0,1,1
Betrayed,,0,0,0,0
The Navigator: A Medieval Odyssey,21 wins & 4 nominations.,0,21,4,25
Pass the Ammo,,0,0,0,0
D.O.A.,1 win.,0,1,0,1
Camille Claudel,Nominated for 2 Oscars. Another 7 wins & 12 nominations.,2,7,12,21
Elvira: Mistress of the Dark,1 win & 4 nominations.,0,1,4,5
The Seventh Sign,1 win & 1 nomination.,0,1,1,2
The Serpent and the Rainbow,1 nomination.,0,0,1,1
Cameron's Closet,1 nomination.,0,0,1,1
Patty Hearst,2 nominations.,0,0,2,2
Red Heat,,0,0,0,0
Feds,,0,0,0,0
Permanent Record,,0,0,0,0
Dangerous Liaisons,Won 3 Oscars. Another 18 wins & 21 nominations.,3,18,21,42
Rambo III,2 wins & 5 nominations.,0,2,5,7
Sweet Hearts Dance,,0,0,0,0
Drowning by Numbers,3 wins & 1 nomination.,0,3,1,4
Fresh Horses,,0,0,0,0
"Distant Voices, Still Lives",10 wins & 7 nominations.,0,10,7,17
Crossing Delancey,2 nominations.,0,0,2,2
Funny Farm,,0,0,0,0
Dirty Rotten Scoundrels,1 win & 1 nomination.,0,1,1,2
Gandahar,1 nomination.,0,0,1,1
Another Woman,1 win & 3 nominations.,0,1,3,4
The Wrong Guys,,0,0,0,0
Shoot to Kill,2 nominations.,0,0,2,2
Short Circuit 2,2 nominations.,0,0,2,2
Mystic Pizza,1 win & 4 nominations.,0,1,4,5
My Stepmother Is an Alien,4 nominations.,0,0,4,4
They Live,3 nominations.,0,0,3,3
Things Change,2 wins & 2 nominations.,0,2,2,4
Switching Channels,2 nominations.,0,0,2,2
Dead Ringers,20 wins & 14 nominations.,0,20,14,34
The Great Outdoors,,0,0,0,0
And God Created Woman,1 nomination.,0,0,1,1
Spellbinder,,0,0,0,0
Crocodile Dundee II,2 wins.,0,2,0,2
The House on Carroll Street,1 win.,0,1,0,1
Critters 2,1 win & 3 nominations.,0,1,3,4
Casual Sex?,,0,0,0,0
Braddock: Missing in Action III,1 nomination.,0,0,1,1
Mr. North,,0,0,0,0
Some Girls,1 win.,0,1,0,1
Taffin,,0,0,0,0
Tiger Warsaw,,0,0,0,0
Time of the Gypsies,3 wins & 5 nominations.,0,3,5,8
She's Having a Baby,,0,0,0,0
Die Hard,Nominated for 4 Oscars. Another 8 wins & 2 nominations.,4,8,2,14
Dominick and Eugene,Nominated for 1 Golden Globe. Another 1 win & 1 nomination.,0,1,2,3
Bloodsport,1 nomination.,0,0,1,1
Apartment Zero,5 wins & 1 nomination.,0,5,1,6
Fright Night Part 2,2 nominations.,0,0,2,2
Shakedown,,0,0,0,0
Appointment with Death,,0,0,0,0
Night of the Demons,,0,0,0,0
Stand and Deliver,Nominated for 1 Oscar. Another 11 wins & 6 nominations.,1,11,6,18
Rampage,7 nominations.,0,0,7,7
Light of Day,1 nomination.,0,0,1,1
Broadcast News,Nominated for 7 Oscars. Another 15 wins & 17 nominations.,7,15,17,39
Benji the Hunted,1 win & 1 nomination.,0,1,1,2
Spaceballs,1 win.,0,1,0,1
Slam Dance,2 nominations.,0,0,2,2
Enemy Territory,,0,0,0,0
Walk Like a Man,,0,0,0,0
Like Father Like Son,23 wins & 47 nominations.,0,23,47,70
Real Men,,0,0,0,0
The Bedroom Window,,0,0,0,0
Black Widow,,0,0,0,0
Boyfriends and Girlfriends,1 win & 4 nominations.,0,1,4,5
Born in East L.A.,4 wins.,0,4,0,4
Wall Street,Won 1 Oscar. Another 9 wins & 5 nominations.,1,9,5,15
Wisdom,1 nomination.,0,0,1,1
The Fourth Protocol,1 nomination.,0,0,1,1
3 Men and a Baby,,0,0,0,0
Deadly Illusion,,0,0,0,0
Empire of the Sun,Nominated for 6 Oscars. Another 13 wins & 11 nominations.,6,13,11,30
Innerspace,Won 1 Oscar. Another 1 win & 4 nominations.,1,1,4,6
Wanted: Dead or Alive,1 nomination.,0,0,1,1
Wish You Were Here,10 wins & 23 nominations.,0,10,23,33
Dragnet,,0,0,0,0
Best Seller,2 nominations.,0,0,2,2
Dead of Winter,,0,0,0,0
Raising Arizona,4 nominations.,0,0,4,4
Death Before Dishonor,,0,0,0,0
The Allnighter,,0,0,0,0
Someone to Watch Over Me,2 nominations.,0,0,2,2
Blind Date,1 win.,0,1,0,1
Prom Night II,3 nominations.,0,0,3,3
The Principal,1 nomination.,0,0,1,1
Death Wish 4: The Crackdown,,0,0,0,0
The Princess Bride,Nominated for 1 Oscar. Another 7 wins & 8 nominations.,1,7,8,16
The Hanoi Hilton,,0,0,0,0
*batteries not included,2 wins & 1 nomination.,0,2,1,3
September,,0,0,0,0
Some Kind of Wonderful,1 win.,0,1,0,1
Radio Days,Nominated for 2 Oscars. Another 3 wins & 9 nominations.,2,3,9,14
Hunk,,0,0,0,0
Zombie High,,0,0,0,0
The Hidden,4 wins & 6 nominations.,0,4,6,10
In the Mood,,0,0,0,0
The Kindred,,0,0,0,0
The Last Emperor,Won 9 Oscars. Another 51 wins & 22 nominations.,9,51,22,82
The Pick-up Artist,,0,0,0,0
The Killing Time,,0,0,0,0
Ironweed,Nominated for 2 Oscars. Another 2 wins & 2 nominations.,2,2,2,6
Hello Again,1 nomination.,0,0,1,1
Hellraiser,2 wins & 6 nominations.,0,2,6,8
Ishtar,1 win & 3 nominations.,0,1,3,4
A Prayer for the Dying,1 win.,0,1,0,1
Rent-a-Cop,1 win & 1 nomination.,0,1,1,2
Siesta,3 nominations.,0,0,3,3
Jaws: The Revenge,1 win & 7 nominations.,0,1,7,8
World Gone Wild,1 nomination.,0,0,1,1
Eat the Rich,,0,0,0,0
The Grand Highway,8 wins & 4 nominations.,0,8,4,12
Hollywood Shuffle,4 wins & 3 nominations.,0,4,3,7
Stakeout,2 wins.,0,2,0,2
Roxanne,3 wins & 2 nominations.,0,3,2,5
Burglar,,0,0,0,0
84 Charing Cross Road,Won 1 BAFTA Film Award. Another 2 wins & 4 nominations.,0,3,4,7
The Chipmunk Adventure,1 nomination.,0,0,1,1
House of Games,Nominated for 1 Golden Globe. Another 6 wins & 4 nominations.,0,6,5,11
Julia and Julia,1 win & 5 nominations.,0,1,5,6
Disorderlies,,0,0,0,0
Hope and Glory,Nominated for 5 Oscars. Another 16 wins & 24 nominations.,5,16,24,45
La Bamba,3 wins & 3 nominations.,0,3,3,6
The Lost Boys,3 wins & 5 nominations.,0,3,5,8
White of the Eye,,0,0,0,0
The Barbarians,1 nomination.,0,0,1,1
White Water Summer,,0,0,0,0
Prince of Darkness,1 win & 1 nomination.,0,1,1,2
House II: The Second Story,1 nomination.,0,0,1,1
Russkies,,0,0,0,0
The Believers,1 nomination.,0,0,1,1
The Big Town,,0,0,0,0
White Mischief,,0,0,0,0
China Girl,1 nomination.,0,0,1,1
Dirty Dancing,Won 1 Oscar. Another 10 wins & 6 nominations.,1,10,6,17
"Silent Night, Deadly Night 2",,0,0,0,0
The Monster Squad,3 wins & 4 nominations.,0,3,4,7
The Living Daylights,3 wins & 4 nominations.,0,3,4,7
Withnail & I,1 win & 1 nomination.,0,1,1,2
Lethal Weapon,Nominated for 1 Oscar. Another 7 wins & 1 nomination.,1,7,1,9
Return to Horror High,,0,0,0,0
Housekeeping,2 wins & 3 nominations.,0,2,3,5
The Glass Menagerie,1 win & 6 nominations.,0,1,6,7
A Nightmare on Elm Street 3: Dream Warriors,1 win & 4 nominations.,0,1,4,5
Less Than Zero,1 nomination.,0,0,1,1
Date with an Angel,1 nomination.,0,0,1,1
Revenge of the Nerds II: Nerds in Paradise,,0,0,0,0
Leonard Part 6,3 wins & 4 nominations.,0,3,4,7
Hiding Out,1 win.,0,1,0,1
A Month in the Country,1 win.,0,1,0,1
Steele Justice,,0,0,0,0
The Garbage Pail Kids Movie,4 nominations.,0,0,4,4
Wings of Desire,Nominated for 1 BAFTA Film Award. Another 19 wins & 13 nominations.,0,19,14,33
Cold Steel,,0,0,0,0
A Man in Love,3 nominations.,0,0,3,3
Shy People,2 wins & 2 nominations.,0,2,2,4
The Belly of an Architect,2 nominations.,0,0,2,2
Square Dance,1 nomination.,0,0,1,1
Beverly Hills Cop II,Nominated for 1 Oscar. Another 6 wins & 3 nominations.,1,6,3,10
Steel Dawn,,0,0,0,0
"Rita, Sue and Bob Too",,0,0,0,0
Who's That Girl,Nominated for 1 Golden Globe. Another 2 wins & 6 nominations.,0,2,7,9
Beyond Therapy,,0,0,0,0
Prison,1 nomination.,0,0,1,1
Ernest Goes to Camp,1 nomination.,0,0,1,1
Back to the Beach,,0,0,0,0
Tough Guys Don't Dance,1 win & 10 nominations.,0,1,10,11
Mannequin,Nominated for 1 Oscar. Another 5 wins & 3 nominations.,1,5,3,9
T�nel al infierno,,0,0,0,0
Baby Boom,Nominated for 2 Golden Globes. Another 3 nominations.,0,0,5,5
The Year My Voice Broke,6 wins & 3 nominations.,0,6,3,9
Nadine,1 win & 1 nomination.,0,1,1,2
The Squeeze,,0,0,0,0
Gardens of Stone,2 nominations.,0,0,2,2
"Good Morning, Vietnam",Nominated for 1 Oscar. Another 7 wins & 3 nominations.,1,7,3,11
Summer School,1 nomination.,0,0,1,1
No Way Out,,0,0,0,0
Babette's Feast,Won 1 Oscar. Another 11 wins & 9 nominations.,1,11,9,21
Outrageous Fortune,Nominated for 1 Golden Globe. Another 2 wins.,0,2,1,3
Over the Top,4 wins & 2 nominations.,0,4,2,6
The Curse,1 nomination.,0,0,1,1
Anguish,5 wins & 2 nominations.,0,5,2,7
Overboard,3 nominations.,0,0,3,3
Five Corners,1 win & 3 nominations.,0,1,3,4
Malone,,0,0,0,0
My Demon Lover,1 nomination.,0,0,1,1
Cross My Heart,,0,0,0,0
Angel Heart,2 wins & 4 nominations.,0,2,4,6
Can't Buy Me Love,1 win & 3 nominations.,0,1,3,4
Making Mr. Right,,0,0,0,0
My Best Friend Is a Vampire,,0,0,0,0
Cyclone,,0,0,0,0
Near Dark,1 win & 8 nominations.,0,1,8,9
The Sicilian,,0,0,0,0
Nuts,Nominated for 3 Golden Globes. Another 1 nomination.,0,0,4,4
The Untouchables,Won 1 Oscar. Another 10 wins & 16 nominations.,1,10,16,27
Amazon Women on the Moon,,0,0,0,0
Suspect,,0,0,0,0
Assassination,16 wins & 51 nominations.,0,16,51,67
North Shore,,0,0,0,0
No Man's Land,Won 1 Oscar. Another 28 wins & 25 nominations.,1,28,25,54
The Trouble with Spies,,0,0,0,0
The Dead,2 nominations.,0,0,2,2
American Ninja 2: The Confrontation,,0,0,0,0
Maurice,Nominated for 1 Oscar. Another 4 wins & 2 nominations.,1,4,2,7
Matewan,Nominated for 1 Oscar. Another 2 wins & 7 nominations.,1,2,7,10
Aria,1 nomination.,0,0,1,1
The Witches of Eastwick,Nominated for 2 Oscars. Another 5 wins & 11 nominations.,2,5,11,18
Masters of the Universe,2 wins & 5 nominations.,0,2,5,7
Surrender,,0,0,0,0
Superman IV: The Quest for Peace,2 wins & 6 nominations.,0,2,6,8
Au Revoir les Enfants,Nominated for 2 Oscars. Another 28 wins & 11 nominations.,2,28,11,41
Swimming to Cambodia,5 nominations.,0,0,5,5
Teen Wolf Too,,0,0,0,0
Cry Freedom,Nominated for 3 Oscars. Another 5 wins & 13 nominations.,3,5,13,21
From a Whisper to a Scream,,0,0,0,0
Hamburger Hill,,0,0,0,0
From the Hip,1 nomination.,0,0,1,1
Full Metal Jacket,Nominated for 1 Oscar. Another 8 wins & 14 nominations.,1,8,14,23
Flowers in the Attic,1 win & 1 nomination.,0,1,1,2
Maid to Order,,0,0,0,0
"No Retreat, No Surrender 2",,0,0,0,0
Tin Men,,0,0,0,0
Adventures in Babysitting,2 wins & 4 nominations.,0,2,4,6
Penitentiary III,,0,0,0,0
Extreme Prejudice,,0,0,0,0
Personal Services,Nominated for 2 BAFTA Film Awards. Another 1 win.,0,1,2,3
Straight to Hell,,0,0,0,0
Critical Condition,,0,0,0,0
Moonstruck,Won 3 Oscars. Another 15 wins & 19 nominations.,3,15,19,37
Three O'Clock High,,0,0,0,0
Creepshow 2,1 nomination.,0,0,1,1
The Running Man,1 win & 3 nominations.,0,1,3,4
Street Smart,Nominated for 1 Oscar. Another 6 wins & 2 nominations.,1,6,2,9
Creepozoids,,0,0,0,0
Morgan Stewart's Coming Home,,0,0,0,0
Three for the Road,,0,0,0,0
Fatal Beauty,2 wins.,0,2,0,2
Peter Kenna's The Good Wife,,0,0,0,0
Predator,Nominated for 1 Oscar. Another 3 wins & 5 nominations.,1,3,5,9
Police Academy 4: Citizens on Patrol,2 nominations.,0,0,2,2
Fatal Attraction,Nominated for 6 Oscars. Another 7 wins & 16 nominations.,6,7,16,29
Prick Up Your Ears,Nominated for 1 Golden Globe. Another 5 wins & 7 nominations.,0,5,8,13
Evil Dead II,5 nominations.,0,0,5,5
"Planes, Trains & Automobiles",1 nomination.,0,0,1,1
Pelle the Conqueror,Won 1 Oscar. Another 21 wins & 9 nominations.,1,21,9,31
The Secret of My Succe$s,,0,0,0,0
The Rosary Murders,2 wins.,0,2,0,2
Harry and the Hendersons,Won 1 Oscar. Another 1 win & 7 nominations.,1,1,7,9
Barfly,5 nominations.,0,0,5,5
Throw Momma from the Train,Nominated for 1 Oscar. Another 2 wins & 3 nominations.,1,2,3,6
Bagdad Cafe,Nominated for 1 Oscar. Another 14 wins & 5 nominations.,1,14,5,20
In the Shadow of Kilimanjaro,,0,0,0,0
The Karate Kid Part II,Nominated for 1 Oscar. Another 4 wins & 2 nominations.,1,4,2,7
Night of the Creeps,1 win.,0,1,0,1
Wired to Kill,,0,0,0,0
Solarbabies,1 nomination.,0,0,1,1
The Boy in Blue,3 nominations.,0,0,3,3
Wise Guys,,0,0,0,0
April Fool's Day,,0,0,0,0
Just Between Friends,,0,0,0,0
The Best of Times,,0,0,0,0
Witchboard,,0,0,0,0
The Whistle Blower,1 nomination.,0,0,1,1
9� Weeks,,0,0,0,0
Tai-Pan,2 nominations.,0,0,2,2
Detective School Dropouts,,0,0,0,0
Armed Response,,0,0,0,0
Crimes of the Heart,Nominated for 3 Oscars. Another 3 wins & 1 nomination.,3,3,1,7
Something Wild,Nominated for 3 Golden Globes. Another 2 wins & 3 nominations.,0,2,6,8
"No Retreat, No Surrender",,0,0,0,0
No Mercy,1 win & 1 nomination.,0,1,1,2
Howard the Duck,5 wins & 4 nominations.,0,5,4,9
Stand by Me,Nominated for 1 Oscar. Another 5 wins & 10 nominations.,1,5,10,16
Wildcats,2 nominations.,0,0,2,2
Down by Law,4 wins & 6 nominations.,0,4,6,10
Down and Out in Beverly Hills,Nominated for 2 Golden Globes. Another 1 win & 3 nominations.,0,1,5,6
American Anthem,1 nomination.,0,0,1,1
�Three Amigos!,,0,0,0,0
Willy/Milly,,0,0,0,0
Troll,1 nomination.,0,0,1,1
The Boy Who Could Fly,3 wins & 5 nominations.,0,3,5,8
"'night, Mother",Nominated for 1 Golden Globe. Another 1 nomination.,0,0,2,2
Care Bears Movie II: A New Generation,1 nomination.,0,0,1,1
Clockwise,1 win.,0,1,0,1
Armed and Dangerous,,0,0,0,0
Kangaroo,,0,0,0,0
The Ladies Club,,0,0,0,0
Invaders from Mars,2 nominations.,0,0,2,2
Trick or Treat,,0,0,0,0
Sweet Liberty,,0,0,0,0
From Beyond,3 wins & 3 nominations.,0,3,3,6
She's Gotta Have It,4 wins & 2 nominations.,0,4,2,6
Critters,3 nominations.,0,0,3,3
8 Million Ways to Die,1 nomination.,0,0,1,1
Tough Guys,,0,0,0,0
Touch and Go,,0,0,0,0
52 Pick-Up,1 nomination.,0,0,1,1
"Jo Jo Dancer, Your Life Is Calling",1 nomination.,0,0,1,1
An American Tail,Nominated for 1 Oscar. Another 6 wins & 6 nominations.,1,6,6,13
Sid and Nancy,Nominated for 1 BAFTA Film Award. Another 4 wins & 1 nomination.,0,4,2,6
Body Slam,,0,0,0,0
Murphy's Law,,0,0,0,0
Jean de Florette,Won 4 BAFTA Film Awards. Another 7 wins & 17 nominations.,0,11,17,28
My Little Pony: The Movie,4 wins & 6 nominations.,0,4,6,10
Youngblood,1 win.,0,1,0,1
Sky Bandits,,0,0,0,0
The Decline of the American Empire,Nominated for 1 Oscar. Another 13 wins & 6 nominations.,1,13,6,20
Born American,,0,0,0,0
Jason Lives: Friday the 13th Part VI,,0,0,0,0
The Great Mouse Detective,1 win & 3 nominations.,0,1,3,4
My Chauffeur,,0,0,0,0
Top Gun,Won 1 Oscar. Another 10 wins & 5 nominations.,1,10,5,16
Jake Speed,,0,0,0,0
Deadly Friend,3 nominations.,0,0,3,3
'Round Midnight,Won 1 Oscar. Another 10 wins & 12 nominations.,1,10,12,23
Modern Girls,,0,0,0,0
Jackals,,0,0,0,0
Desert Bloom,1 win.,0,1,0,1
Mona Lisa,Nominated for 1 Oscar. Another 14 wins & 13 nominations.,1,14,13,28
Thunder Run,,0,0,0,0
SpaceCamp,1 nomination.,0,0,1,1
The Whoopee Boys,,0,0,0,0
Shanghai Surprise,1 win & 6 nominations.,0,1,6,7
Jumpin' Jack Flash,2 nominations.,0,0,2,2
Brighton Beach Memoirs,,0,0,0,0
The Big Easy,4 wins & 4 nominations.,0,4,4,8
Deadtime Stories,,0,0,0,0
Gothic,2 wins & 1 nomination.,0,2,1,3
Iron Eagle,,0,0,0,0
Native Son,4 wins & 6 nominations.,0,4,6,10
The Delta Force,1 nomination.,0,0,1,1
Defense of the Realm,Won 1 BAFTA Film Award. Another 6 wins & 2 nominations.,0,7,2,9
The Wraith,,0,0,0,0
Blue City,5 nominations.,0,0,5,5
The Gospel According to Vic,1 win & 1 nomination.,0,1,1,2
Castaway,,0,0,0,0
Blue Velvet,Nominated for 1 Oscar. Another 18 wins & 17 nominations.,1,18,17,36
Crocodile Dundee,Nominated for 1 Oscar. Another 3 wins & 7 nominations.,1,3,7,11
Short Circuit,1 win & 3 nominations.,0,1,3,4
GoBots: Battle of the Rock Lords,,0,0,0,0
The Adventures of Milo and Otis,1 win & 2 nominations.,0,1,2,3
A Fine Mess,,0,0,0,0
The Golden Child,2 nominations.,0,0,2,2
That's Life!,4 nominations.,0,0,4,4
Dangerously Close,,0,0,0,0
Raw Deal,,0,0,0,0
Band of the Hand,1 nomination.,0,0,1,1
Streets of Gold,,0,0,0,0
Peggy Sue Got Married,Nominated for 3 Oscars. Another 4 wins & 8 nominations.,3,4,8,15
TerrorVision,1 nomination.,0,0,1,1
Ferris Bueller's Day Off,Nominated for 1 Golden Globe. Another 2 wins.,0,2,1,3
Reform School Girls,,0,0,0,0
Hardbodies 2,,0,0,0,0
Eliminators,,0,0,0,0
The Fringe Dwellers,1 win & 7 nominations.,0,1,7,8
The Color of Money,Won 1 Oscar. Another 2 wins & 10 nominations.,1,2,10,13
Under the Cherry Moon,5 wins & 4 nominations.,0,5,4,9
The Name of the Rose,Won 2 BAFTA Film Awards. Another 15 wins & 6 nominations.,0,17,6,23
The Naked Cage,,0,0,0,0
Malcolm,9 wins.,0,9,0,9
Summer,5 wins.,0,5,0,5
Let's Get Harry,,0,0,0,0
Fire with Fire,1 win.,0,1,0,1
Firewalker,,0,0,0,0
Oviri,2 wins & 1 nomination.,0,2,1,3
Children of a Lesser God,Won 1 Oscar. Another 5 wins & 11 nominations.,1,5,11,17
The Mosquito Coast,Nominated for 2 Golden Globes. Another 1 win & 1 nomination.,0,1,3,4
The Morning After,,0,0,0,0
Man Facing Southeast,13 wins & 2 nominations.,0,13,2,15
Legal Eagles,1 win.,0,1,0,1
Hannah and Her Sisters,Won 3 Oscars. Another 24 wins & 26 nominations.,3,24,26,53
Belizaire the Cajun,3 nominations.,0,0,3,3
Black Moon Rising,1 nomination.,0,0,1,1
Heartbreak Ridge,Nominated for 1 Oscar. Another 3 wins.,1,3,0,4
Pretty in Pink,1 win.,0,1,0,1
Every Time We Say Goodbye,,0,0,0,0
Extremities,Nominated for 1 Golden Globe. Another 1 win.,0,1,1,2
Heathcliff: The Movie,,0,0,0,0
F/X,1 nomination.,0,0,1,1
About Last Night...,1 nomination.,0,0,1,1
Vamp,2 nominations.,0,0,2,2
Psicosis III,,0,0,0,0
Poltergeist II: The Other Side,Nominated for 1 Oscar. Another 1 win & 4 nominations.,1,1,4,6
Little Shop of Horrors,Nominated for 2 Oscars. Another 2 wins & 12 nominations.,2,2,12,16
Police Academy 3: Back in Training,1 win.,0,1,0,1
Absolute Beginners,,0,0,0,0
Violets Are Blue...,,0,0,0,0
The Fly,Won 1 Oscar. Another 6 wins & 10 nominations.,1,6,10,17
Platoon,Won 4 Oscars. Another 20 wins & 15 nominations.,4,20,15,39
Low Blow,,0,0,0,0
Quicksilver,,0,0,0,0
Quiet Cool,,0,0,0,0
Ginger and Fred,Nominated for 1 Golden Globe. Another 18 wins & 17 nominations.,0,18,18,36
Rad,1 win & 1 nomination.,0,1,1,2
Lucas,3 nominations.,0,0,3,3
Link,1 win & 2 nominations.,0,1,2,3
Haunted Honeymoon,1 win.,0,1,0,1
The Clan of the Cave Bear,,0,0,0,0
The Money Pit,,0,0,0,0
Back to School,1 win & 2 nominations.,0,1,2,3
The Assault,,0,0,0,0
Matador,6 wins & 6 nominations.,0,6,6,12
Club Paradise,1 nomination.,0,0,1,1
The Transformers: The Movie,2 nominations.,0,0,2,2
Nutcracker,1 nomination.,0,0,1,1
The Longshot,,0,0,0,0
Heartburn,1 win & 1 nomination.,0,1,1,2
Ruthless People,1 win & 3 nominations.,0,1,3,4
Sacrifice,,0,0,0,0
Allan Quatermain and the Lost City of Gold,1 nomination.,0,0,1,1
Gung Ho,1 win.,0,1,0,1
Knights of the City,,0,0,0,0
At Close Range,2 wins & 2 nominations.,0,2,2,4
Nothing in Common,1 nomination.,0,0,1,1
Maximum Overdrive,4 nominations.,0,0,4,4
Nomads,,0,0,0,0
True Stories,1 win & 2 nominations.,0,1,2,3
Star Trek IV: The Voyage Home,Nominated for 4 Oscars. Another 4 wins & 14 nominations.,4,4,14,22
Meatballs III: Summer Job,,0,0,0,0
King Kong Lives,2 nominations.,0,0,2,2
Killer Party,,0,0,0,0
Where the River Runs Black,,0,0,0,0
Otello,Nominated for 1 Oscar. Another 2 wins & 7 nominations.,1,2,7,10
Weekend Warriors,,0,0,0,0
Highlander,,0,0,0,0
The Mission,Won 1 Oscar. Another 14 wins & 27 nominations.,1,14,27,42
A Man and a Woman: 20 Years Later,,0,0,0,0
Aliens,Won 2 Oscars. Another 18 wins & 23 nominations.,2,18,23,43
Out of Bounds,,0,0,0,0
River's Edge,4 wins & 5 nominations.,0,4,5,9
The Men's Club,,0,0,0,0
Manhunter,1 win & 1 nomination.,0,1,1,2
Manon of the Spring,Nominated for 1 BAFTA Film Award. Another 4 wins & 2 nominations.,0,4,3,7
Flight of the Navigator,4 nominations.,0,0,4,4
Lady Jane,,0,0,0,0
Labyrinth,Nominated for 1 BAFTA Film Award. Another 3 nominations.,0,0,4,4
One More Saturday Night,,0,0,0,0
Duet for One,Nominated for 1 Golden Globe. Another 1 nomination.,0,0,2,2
Cobra,6 nominations.,0,0,6,6
One Crazy Summer,,0,0,0,0
The Manhattan Project,1 win & 1 nomination.,0,1,1,2
Avenging Force,,0,0,0,0
On the Edge,1 win & 1 nomination.,0,1,1,2
Bullies,1 nomination.,0,0,1,1
Half Moon Street,1 win & 1 nomination.,0,1,1,2
Hoosiers,Nominated for 2 Oscars. Another 3 wins & 3 nominations.,2,3,3,8
Off Beat,7 wins & 3 nominations.,0,7,3,10
Big Trouble in Little China,1 win & 1 nomination.,0,1,1,2
Biggles: Adventures in Time,,0,0,0,0
Soul Man,,0,0,0,0
